,السنة,الربع,المنطقة,النشاط الاقتصادي,حجم المنشأة,عدد المنشآت,عدد العاملين السعوديين,عدد السعوديين (ذكور),عدد السعوديات (إناث),عدد العاملين الأجانب,عدد الأجانب (ذكور),عدد الأجنبيات (إناث)
852,2023,1,المنطقة الشرقية,تشييد المباني,صغيرة,5016,11316,5856,5460,67734,67530,204
853,2023,1,المنطقة الشرقية,تشييد المباني,كبيرة,139,25493,17518,7975,124966,124301,665
854,2023,1,المنطقة الشرقية,تشييد المباني,متناهية الصغر,12802,3061,1551,1510,30782,30671,111
855,2023,1,المنطقة الشرقية,تشييد المباني,متوسطة,753,11023,6412,4611,64350,64223,127
856,2023,1,منطقة الباحة,تشييد المباني,صغيرة,216,354,240,114,2130,2122,8
857,2023,1,منطقة الباحة,تشييد المباني,متناهية الصغر,1283,223,123,100,3233,3225,8
858,2023,1,منطقة الباحة,تشييد المباني,متوسطة,4,64,48,16,296,296,0
859,2023,1,منطقة الجوف,تشييد المباني,صغيرة,243,332,207,125,2547,2540,7
860,2023,1,منطقة الجوف,تشييد المباني,كبيرة,2,295,217,78,588,497,91
861,2023,1,منطقة الجوف,تشييد المباني,متناهية الصغر,1638,211,134,77,4020,4012,8
862,2023,1,منطقة الجوف,تشييد المباني,متوسطة,7,102,66,36,466,466,0
863,2023,1,منطقة الحدود الشمالية,تشييد المباني,صغيرة,176,275,160,115,1777,1771,6
864,2023,1,منطقة الحدود الشمالية,تشييد المباني,كبيرة,3,380,223,157,2379,2355,24
865,2023,1,منطقة الحدود الشمالية,تشييد المباني,متناهية الصغر,1609,146,79,67,4299,4291,8
866,2023,1,منطقة الحدود الشمالية,تشييد المباني,متوسطة,9,109,64,45,670,670,0
867,2023,1,منطقة الرياض,تشييد المباني,صغيرة,7032,15183,6597,8586,89963,89293,670
868,2023,1,منطقة الرياض,تشييد المباني,كبيرة,368,27021,14746,12275,227441,224833,2608
869,2023,1,منطقة الرياض,تشييد المباني,متناهية الصغر,24451,5546,2590,2956,54430,53972,458
870,2023,1,منطقة الرياض,تشييد المباني,متوسطة,1129,14300,6877,7423,105577,104648,929
871,2023,1,منطقة القصيم,تشييد المباني,صغيرة,1329,1977,1167,810,15978,15873,105
872,2023,1,منطقة القصيم,تشييد المباني,كبيرة,32,476,288,188,13854,13773,81
873,2023,1,منطقة القصيم,تشييد المباني,متناهية الصغر,9515,1039,574,465,22829,22784,45
874,2023,1,منطقة القصيم,تشييد المباني,متوسطة,156,1023,624,399,16680,16610,70
875,2023,1,منطقة المدينة المنورة,تشييد المباني,صغيرة,1305,2354,1307,1047,14418,14347,71
876,2023,1,منطقة المدينة المنورة,تشييد المباني,كبيرة,10,1531,645,886,13886,13416,470
877,2023,1,منطقة المدينة المنورة,تشييد المباني,متناهية الصغر,6165,985,547,438,15520,15456,64
878,2023,1,منطقة المدينة المنورة,تشييد المباني,متوسطة,74,1055,600,455,5920,5910,10
879,2023,1,منطقة تبوك,تشييد المباني,صغيرة,304,488,259,229,2952,2948,4
880,2023,1,منطقة تبوك,تشييد المباني,كبيرة,1,47,47,0,240,240,0
881,2023,1,منطقة تبوك,تشييد المباني,متناهية الصغر,2811,417,211,206,7224,7213,11
882,2023,1,منطقة تبوك,تشييد المباني,متوسطة,12,107,52,55,930,918,12
883,2023,1,منطقة جازان,تشييد المباني,صغيرة,365,595,294,301,3591,3583,8
884,2023,1,منطقة جازان,تشييد المباني,كبيرة,1,24,13,11,461,461,0
885,2023,1,منطقة جازان,تشييد المباني,متناهية الصغر,4244,520,281,239,11008,10981,27
886,2023,1,منطقة جازان,تشييد المباني,متوسطة,12,212,119,93,1020,1007,13
887,2023,1,منطقة حائل,تشييد المباني,صغيرة,381,507,231,276,4035,4016,19
888,2023,1,منطقة حائل,تشييد المباني,كبيرة,3,18,6,12,1083,1083,0
889,2023,1,منطقة حائل,تشييد المباني,متناهية الصغر,3182,352,186,166,7669,7650,19
890,2023,1,منطقة حائل,تشييد المباني,متوسطة,28,373,232,141,2352,2351,1
891,2023,1,منطقة عسير,تشييد المباني,صغيرة,981,1543,914,629,9636,9597,39
892,2023,1,منطقة عسير,تشييد المباني,كبيرة,3,307,292,15,1415,1415,0
893,2023,1,منطقة عسير,تشييد المباني,متناهية الصغر,8294,1156,656,500,19950,19918,32
894,2023,1,منطقة عسير,تشييد المباني,متوسطة,39,646,438,208,2947,2941,6
895,2023,1,منطقة مكة المكرمة,تشييد المباني,صغيرة,5237,9499,4530,4969,60552,60037,515
896,2023,1,منطقة مكة المكرمة,تشييد المباني,كبيرة,92,13017,9148,3869,88813,88090,723
897,2023,1,منطقة مكة المكرمة,تشييد المباني,متناهية الصغر,22418,4296,2120,2176,55057,54559,498
898,2023,1,منطقة مكة المكرمة,تشييد المباني,متوسطة,474,7235,4085,3150,39388,39055,333
899,2023,1,منطقة نجران,تشييد المباني,صغيرة,374,564,276,288,3989,3977,12
900,2023,1,منطقة نجران,تشييد المباني,كبيرة,8,938,479,459,2769,2761,8
901,2023,1,منطقة نجران,تشييد المباني,متناهية الصغر,2727,277,136,141,6447,6418,29
902,2023,1,منطقة نجران,تشييد المباني,متوسطة,44,674,424,250,4270,4268,2
1400,2023,1,المنطقة الشرقية,أنشطة المعمارية والهندسية ، والاختبارات الفنية والتحليل,صغيرة,266,1687,977,710,2386,2345,41
1401,2023,1,المنطقة الشرقية,أنشطة المعمارية والهندسية ، والاختبارات الفنية والتحليل,كبيرة,23,5008,4020,988,6431,6406,25
1402,2023,1,المنطقة الشرقية,أنشطة المعمارية والهندسية ، والاختبارات الفنية والتحليل,متناهية الصغر,466,368,219,149,823,813,10
1403,2023,1,المنطقة الشرقية,أنشطة المعمارية والهندسية ، والاختبارات الفنية والتحليل,متوسطة,70,2962,2211,751,3924,3907,17
1404,2023,1,منطقة الباحة,أنشطة المعمارية والهندسية ، والاختبارات الفنية والتحليل,صغيرة,18,69,41,28,134,133,1
1405,2023,1,منطقة الباحة,أنشطة المعمارية والهندسية ، والاختبارات الفنية والتحليل,متناهية الصغر,96,16,7,9,203,202,1
1406,2023,1,منطقة الجوف,أنشطة المعمارية والهندسية ، والاختبارات الفنية والتحليل,صغيرة,13,46,30,16,138,137,1
1407,2023,1,منطقة الجوف,أنشطة المعمارية والهندسية ، والاختبارات الفنية والتحليل,متناهية الصغر,104,36,22,14,214,212,2
1408,2023,1,منطقة الحدود الشمالية,أنشطة المعمارية والهندسية ، والاختبارات الفنية والتحليل,صغيرة,8,34,21,13,39,39,0
1409,2023,1,منطقة الحدود الشمالية,أنشطة المعمارية والهندسية ، والاختبارات الفنية والتحليل,متناهية الصغر,53,18,11,7,108,107,1
1410,2023,1,منطقة الرياض,أنشطة المعمارية والهندسية ، والاختبارات الفنية والتحليل,صغيرة,499,2911,1666,1245,4387,4288,99
1411,2023,1,منطقة الرياض,أنشطة المعمارية والهندسية ، والاختبارات الفنية والتحليل,كبيرة,28,6421,4369,2052,8696,8564,132
1412,2023,1,منطقة الرياض,أنشطة المعمارية والهندسية ، والاختبارات الفنية والتحليل,متناهية الصغر,3362,923,489,434,7433,7369,64
1413,2023,1,منطقة الرياض,أنشطة المعمارية والهندسية ، والاختبارات الفنية والتحليل,متوسطة,113,5675,3510,2165,7401,7179,222
1414,2023,1,منطقة القصيم,أنشطة المعمارية والهندسية ، والاختبارات الفنية والتحليل,صغيرة,41,206,131,75,334,332,2
1415,2023,1,منطقة القصيم,أنشطة المعمارية والهندسية ، والاختبارات الفنية والتحليل,متناهية الصغر,168,74,56,18,316,316,0
1416,2023,1,منطقة القصيم,أنشطة المعمارية والهندسية ، والاختبارات الفنية والتحليل,متوسطة,5,206,133,73,224,223,1
1417,2023,1,منطقة المدينة المنورة,أنشطة المعمارية والهندسية ، والاختبارات الفنية والتحليل,صغيرة,72,313,178,135,622,616,6
1418,2023,1,منطقة المدينة المنورة,أنشطة المعمارية والهندسية ، والاختبارات الفنية والتحليل,كبيرة,1,153,82,71,179,178,1
1419,2023,1,منطقة المدينة المنورة,أنشطة المعمارية والهندسية ، والاختبارات الفنية والتحليل,متناهية الصغر,147,67,28,39,285,285,0
1420,2023,1,منطقة المدينة المنورة,أنشطة المعمارية والهندسية ، والاختبارات الفنية والتحليل,متوسطة,7,376,267,109,443,443,0
1421,2023,1,منطقة تبوك,أنشطة المعمارية والهندسية ، والاختبارات الفنية والتحليل,صغيرة,21,100,77,23,171,171,0
1422,2023,1,منطقة تبوك,أنشطة المعمارية والهندسية ، والاختبارات الفنية والتحليل,متناهية الصغر,84,43,20,23,150,146,4
1423,2023,1,منطقة تبوك,أنشطة المعمارية والهندسية ، والاختبارات الفنية والتحليل,متوسطة,1,44,19,25,31,31,0
1424,2023,1,منطقة جازان,أنشطة المعمارية والهندسية ، والاختبارات الفنية والتحليل,صغيرة,22,132,75,57,184,183,1
1425,2023,1,منطقة جازان,أنشطة المعمارية والهندسية ، والاختبارات الفنية والتحليل,متناهية الصغر,151,82,46,36,242,234,8
1426,2023,1,منطقة جازان,أنشطة المعمارية والهندسية ، والاختبارات الفنية والتحليل,متوسطة,1,30,13,17,33,33,0
1427,2023,1,منطقة حائل,أنشطة المعمارية والهندسية ، والاختبارات الفنية والتحليل,صغيرة,19,108,48,60,212,207,5
1428,2023,1,منطقة حائل,أنشطة المعمارية والهندسية ، والاختبارات الفنية والتحليل,متناهية الصغر,165,25,20,5,386,386,0
1429,2023,1,منطقة حائل,أنشطة المعمارية والهندسية ، والاختبارات الفنية والتحليل,متوسطة,1,40,38,2,57,57,0
1430,2023,1,منطقة عسير,أنشطة المعمارية والهندسية ، والاختبارات الفنية والتحليل,صغيرة,58,255,177,78,418,416,2
1431,2023,1,منطقة عسير,أنشطة المعمارية والهندسية ، والاختبارات الفنية والتحليل,متناهية الصغر,258,144,88,56,482,480,2
1432,2023,1,منطقة عسير,أنشطة المعمارية والهندسية ، والاختبارات الفنية والتحليل,متوسطة,1,25,23,2,40,39,1
1433,2023,1,منطقة مكة المكرمة,أنشطة المعمارية والهندسية ، والاختبارات الفنية والتحليل,صغيرة,396,1892,1091,801,3393,3339,54
1434,2023,1,منطقة مكة المكرمة,أنشطة المعمارية والهندسية ، والاختبارات الفنية والتحليل,كبيرة,7,1198,837,361,1760,1746,14
1435,2023,1,منطقة مكة المكرمة,أنشطة المعمارية والهندسية ، والاختبارات الفنية والتحليل,متناهية الصغر,962,594,332,262,1680,1645,35
1436,2023,1,منطقة مكة المكرمة,أنشطة المعمارية والهندسية ، والاختبارات الفنية والتحليل,متوسطة,27,1078,665,413,1564,1550,14
1437,2023,1,منطقة نجران,أنشطة المعمارية والهندسية ، والاختبارات الفنية والتحليل,صغيرة,15,68,43,25,149,149,0
1438,2023,1,منطقة نجران,أنشطة المعمارية والهندسية ، والاختبارات الفنية والتحليل,متناهية الصغر,155,29,14,15,352,350,2
1643,2023,1,المنطقة الشرقية,أنشطة البرمجة الحاسوبية والخبرة الاستشارية وما يتصل بها من أنشطة,صغيرة,108,727,365,362,891,869,22
1644,2023,1,المنطقة الشرقية,أنشطة البرمجة الحاسوبية والخبرة الاستشارية وما يتصل بها من أنشطة,كبيرة,2,672,605,67,287,287,0
1645,2023,1,المنطقة الشرقية,أنشطة البرمجة الحاسوبية والخبرة الاستشارية وما يتصل بها من أنشطة,متناهية الصغر,292,249,118,131,416,408,8
1646,2023,1,المنطقة الشرقية,أنشطة البرمجة الحاسوبية والخبرة الاستشارية وما يتصل بها من أنشطة,متوسطة,11,645,320,325,405,395,10
1647,2023,1,منطقة الباحة,أنشطة البرمجة الحاسوبية والخبرة الاستشارية وما يتصل بها من أنشطة,متناهية الصغر,4,3,2,1,6,6,0
1648,2023,1,منطقة الجوف,أنشطة البرمجة الحاسوبية والخبرة الاستشارية وما يتصل بها من أنشطة,متناهية الصغر,11,9,4,5,25,25,0
1649,2023,1,منطقة الحدود الشمالية,أنشطة البرمجة الحاسوبية والخبرة الاستشارية وما يتصل بها من أنشطة,متناهية الصغر,9,2,1,1,15,15,0
1650,2023,1,منطقة الرياض,أنشطة البرمجة الحاسوبية والخبرة الاستشارية وما يتصل بها من أنشطة,صغيرة,628,4483,2101,2382,5555,5313,242
1651,2023,1,منطقة الرياض,أنشطة البرمجة الحاسوبية والخبرة الاستشارية وما يتصل بها من أنشطة,كبيرة,25,15698,9717,5981,7465,7037,428
1652,2023,1,منطقة الرياض,أنشطة البرمجة الحاسوبية والخبرة الاستشارية وما يتصل بها من أنشطة,متناهية الصغر,1471,1191,563,628,2180,2078,102
1653,2023,1,منطقة الرياض,أنشطة البرمجة الحاسوبية والخبرة الاستشارية وما يتصل بها من أنشطة,متوسطة,103,5100,3016,2084,4667,4521,146
1654,2023,1,منطقة القصيم,أنشطة البرمجة الحاسوبية والخبرة الاستشارية وما يتصل بها من أنشطة,صغيرة,9,53,35,18,75,75,0
1655,2023,1,منطقة القصيم,أنشطة البرمجة الحاسوبية والخبرة الاستشارية وما يتصل بها من أنشطة,متناهية الصغر,71,37,16,21,131,131,0
1656,2023,1,منطقة القصيم,أنشطة البرمجة الحاسوبية والخبرة الاستشارية وما يتصل بها من أنشطة,متوسطة,1,32,7,25,24,24,0
1657,2023,1,منطقة المدينة المنورة,أنشطة البرمجة الحاسوبية والخبرة الاستشارية وما يتصل بها من أنشطة,صغيرة,9,40,13,27,48,48,0
1658,2023,1,منطقة المدينة المنورة,أنشطة البرمجة الحاسوبية والخبرة الاستشارية وما يتصل بها من أنشطة,متناهية الصغر,88,41,15,26,151,145,6
1659,2023,1,منطقة المدينة المنورة,أنشطة البرمجة الحاسوبية والخبرة الاستشارية وما يتصل بها من أنشطة,متوسطة,1,39,37,2,20,20,0
1660,2023,1,منطقة تبوك,أنشطة البرمجة الحاسوبية والخبرة الاستشارية وما يتصل بها من أنشطة,صغيرة,1,5,4,1,13,13,0
1661,2023,1,منطقة تبوك,أنشطة البرمجة الحاسوبية والخبرة الاستشارية وما يتصل بها من أنشطة,متناهية الصغر,20,6,2,4,39,39,0
1662,2023,1,منطقة جازان,أنشطة البرمجة الحاسوبية والخبرة الاستشارية وما يتصل بها من أنشطة,صغيرة,1,1,1,0,7,7,0
1663,2023,1,منطقة جازان,أنشطة البرمجة الحاسوبية والخبرة الاستشارية وما يتصل بها من أنشطة,متناهية الصغر,30,3,2,1,63,63,0
1664,2023,1,منطقة حائل,أنشطة البرمجة الحاسوبية والخبرة الاستشارية وما يتصل بها من أنشطة,صغيرة,2,4,1,3,17,17,0
1665,2023,1,منطقة حائل,أنشطة البرمجة الحاسوبية والخبرة الاستشارية وما يتصل بها من أنشطة,متناهية الصغر,14,6,3,3,26,26,0
1666,2023,1,منطقة عسير,أنشطة البرمجة الحاسوبية والخبرة الاستشارية وما يتصل بها من أنشطة,صغيرة,6,24,14,10,52,51,1
1667,2023,1,منطقة عسير,أنشطة البرمجة الحاسوبية والخبرة الاستشارية وما يتصل بها من أنشطة,متناهية الصغر,61,20,9,11,116,114,2
1668,2023,1,منطقة مكة المكرمة,أنشطة البرمجة الحاسوبية والخبرة الاستشارية وما يتصل بها من أنشطة,صغيرة,145,702,315,387,1158,1102,56
1669,2023,1,منطقة مكة المكرمة,أنشطة البرمجة الحاسوبية والخبرة الاستشارية وما يتصل بها من أنشطة,كبيرة,1,794,767,27,41,38,3
1670,2023,1,منطقة مكة المكرمة,أنشطة البرمجة الحاسوبية والخبرة الاستشارية وما يتصل بها من أنشطة,متناهية الصغر,606,376,183,193,967,922,45
1671,2023,1,منطقة مكة المكرمة,أنشطة البرمجة الحاسوبية والخبرة الاستشارية وما يتصل بها من أنشطة,متوسطة,13,570,300,270,611,589,22
1672,2023,1,منطقة نجران,أنشطة البرمجة الحاسوبية والخبرة الاستشارية وما يتصل بها من أنشطة,متناهية الصغر,11,7,0,7,25,24,1
1759,2023,1,المنطقة الشرقية,الهندسة المدنية,صغيرة,439,1615,852,763,6407,6383,24
1760,2023,1,المنطقة الشرقية,الهندسة المدنية,كبيرة,98,25599,20954,4645,112816,112641,175
1761,2023,1,المنطقة الشرقية,الهندسة المدنية,متناهية الصغر,566,294,157,137,1206,1201,5
1762,2023,1,المنطقة الشرقية,الهندسة المدنية,متوسطة,180,4012,2809,1203,16883,16857,26
1763,2023,1,منطقة الباحة,الهندسة المدنية,صغيرة,4,10,9,1,39,39,0
1764,2023,1,منطقة الباحة,الهندسة المدنية,كبيرة,1,51,46,5,253,253,0
1765,2023,1,منطقة الباحة,الهندسة المدنية,متناهية الصغر,28,9,3,6,63,63,0
1766,2023,1,منطقة الباحة,الهندسة المدنية,متوسطة,2,40,27,13,108,108,0
1767,2023,1,منطقة الجوف,الهندسة المدنية,صغيرة,17,39,26,13,202,202,0
1768,2023,1,منطقة الجوف,الهندسة المدنية,كبيرة,1,121,78,43,281,263,18
1769,2023,1,منطقة الجوف,الهندسة المدنية,متناهية الصغر,46,10,8,2,100,100,0
1770,2023,1,منطقة الجوف,الهندسة المدنية,متوسطة,5,125,89,36,397,396,1
1771,2023,1,منطقة الحدود الشمالية,الهندسة المدنية,صغيرة,7,33,20,13,119,119,0
1772,2023,1,منطقة الحدود الشمالية,الهندسة المدنية,متناهية الصغر,39,10,4,6,96,95,1
1773,2023,1,منطقة الحدود الشمالية,الهندسة المدنية,متوسطة,1,38,20,18,128,128,0
1774,2023,1,منطقة الرياض,الهندسة المدنية,صغيرة,680,2165,1039,1126,9529,9469,60
1775,2023,1,منطقة الرياض,الهندسة المدنية,كبيرة,123,27473,18550,8923,125563,124890,673
1776,2023,1,منطقة الرياض,الهندسة المدنية,متناهية الصغر,1284,515,238,277,2736,2709,27
1777,2023,1,منطقة الرياض,الهندسة المدنية,متوسطة,241,5103,3077,2026,23107,23045,62
1778,2023,1,منطقة القصيم,الهندسة المدنية,صغيرة,70,235,150,85,1103,1102,1
1779,2023,1,منطقة القصيم,الهندسة المدنية,كبيرة,11,1531,959,572,8428,8427,1
1780,2023,1,منطقة القصيم,الهندسة المدنية,متناهية الصغر,158,43,29,14,387,384,3
1781,2023,1,منطقة القصيم,الهندسة المدنية,متوسطة,22,421,344,77,2036,2031,5
1782,2023,1,منطقة المدينة المنورة,الهندسة المدنية,صغيرة,74,243,150,93,979,977,2
1783,2023,1,منطقة المدينة المنورة,الهندسة المدنية,كبيرة,9,950,635,315,3932,3906,26
1784,2023,1,منطقة المدينة المنورة,الهندسة المدنية,متناهية الصغر,187,52,29,23,445,443,2
1785,2023,1,منطقة المدينة المنورة,الهندسة المدنية,متوسطة,22,523,374,149,1884,1882,2
1786,2023,1,منطقة تبوك,الهندسة المدنية,صغيرة,20,64,31,33,261,261,0
1787,2023,1,منطقة تبوك,الهندسة المدنية,كبيرة,1,101,50,51,496,496,0
1788,2023,1,منطقة تبوك,الهندسة المدنية,متناهية الصغر,78,21,8,13,167,166,1
1789,2023,1,منطقة تبوك,الهندسة المدنية,متوسطة,4,83,55,28,300,300,0
1790,2023,1,منطقة جازان,الهندسة المدنية,صغيرة,22,45,20,25,325,324,1
1791,2023,1,منطقة جازان,الهندسة المدنية,كبيرة,1,59,52,7,326,326,0
1792,2023,1,منطقة جازان,الهندسة المدنية,متناهية الصغر,107,23,10,13,264,264,0
1793,2023,1,منطقة جازان,الهندسة المدنية,متوسطة,6,147,90,57,639,639,0
1794,2023,1,منطقة حائل,الهندسة المدنية,صغيرة,25,68,42,26,311,310,1
1795,2023,1,منطقة حائل,الهندسة المدنية,كبيرة,1,125,79,46,641,641,0
1796,2023,1,منطقة حائل,الهندسة المدنية,متناهية الصغر,70,13,6,7,175,173,2
1797,2023,1,منطقة حائل,الهندسة المدنية,متوسطة,7,154,117,37,649,645,4
1798,2023,1,منطقة عسير,الهندسة المدنية,صغيرة,55,145,79,66,630,628,2
1799,2023,1,منطقة عسير,الهندسة المدنية,كبيرة,8,682,560,122,3499,3499,0
1800,2023,1,منطقة عسير,الهندسة المدنية,متناهية الصغر,151,49,29,20,361,361,0
1801,2023,1,منطقة عسير,الهندسة المدنية,متوسطة,26,594,432,162,2388,2387,1
1802,2023,1,منطقة مكة المكرمة,الهندسة المدنية,صغيرة,342,1183,621,562,4643,4612,31
1803,2023,1,منطقة مكة المكرمة,الهندسة المدنية,كبيرة,38,7335,5319,2016,34802,34710,92
1804,2023,1,منطقة مكة المكرمة,الهندسة المدنية,متناهية الصغر,686,246,126,120,1551,1530,21
1805,2023,1,منطقة مكة المكرمة,الهندسة المدنية,متوسطة,97,2034,1315,719,8584,8551,33
1806,2023,1,منطقة نجران,الهندسة المدنية,صغيرة,21,80,36,44,304,304,0
1807,2023,1,منطقة نجران,الهندسة المدنية,كبيرة,6,845,600,245,3401,3401,0
1808,2023,1,منطقة نجران,الهندسة المدنية,متناهية الصغر,61,19,7,12,141,140,1
1809,2023,1,منطقة نجران,الهندسة المدنية,متوسطة,9,137,79,58,706,704,2
1834,2023,1,المنطقة الشرقية,النقل الجوي,صغيرة,16,103,78,25,119,118,1
1835,2023,1,المنطقة الشرقية,النقل الجوي,متناهية الصغر,61,17,9,8,110,110,0
1836,2023,1,منطقة الجوف,النقل الجوي,صغيرة,1,0,0,0,8,8,0
1837,2023,1,منطقة الجوف,النقل الجوي,متناهية الصغر,7,1,1,0,18,18,0
1838,2023,1,منطقة الحدود الشمالية,النقل الجوي,صغيرة,2,11,8,3,25,25,0
1839,2023,1,منطقة الرياض,النقل الجوي,صغيرة,22,131,88,43,231,231,0
1840,2023,1,منطقة الرياض,النقل الجوي,كبيرة,2,1742,1597,145,1406,786,620
1841,2023,1,منطقة الرياض,النقل الجوي,متناهية الصغر,223,43,25,18,562,558,4
1842,2023,1,منطقة الرياض,النقل الجوي,متوسطة,7,282,216,66,272,238,34
1843,2023,1,منطقة القصيم,النقل الجوي,صغيرة,1,1,0,1,5,5,0
1844,2023,1,منطقة القصيم,النقل الجوي,متناهية الصغر,10,3,1,2,19,19,0
1845,2023,1,منطقة المدينة المنورة,النقل الجوي,صغيرة,2,25,23,2,20,20,0
1846,2023,1,منطقة المدينة المنورة,النقل الجوي,متناهية الصغر,10,3,2,1,22,22,0
1847,2023,1,منطقة تبوك,النقل الجوي,صغيرة,2,16,13,3,30,30,0
1848,2023,1,منطقة تبوك,النقل الجوي,متناهية الصغر,6,0,0,0,11,11,0
1849,2023,1,منطقة جازان,النقل الجوي,متناهية الصغر,11,1,1,0,27,27,0
1850,2023,1,منطقة حائل,النقل الجوي,متناهية الصغر,16,0,0,0,46,45,1
1851,2023,1,منطقة عسير,النقل الجوي,صغيرة,1,0,0,0,7,7,0
1852,2023,1,منطقة عسير,النقل الجوي,متناهية الصغر,12,6,4,2,24,24,0
1853,2023,1,منطقة مكة المكرمة,النقل الجوي,صغيرة,25,179,133,46,248,241,7
1854,2023,1,منطقة مكة المكرمة,النقل الجوي,كبيرة,2,5949,5353,596,258,130,128
1855,2023,1,منطقة مكة المكرمة,النقل الجوي,متناهية الصغر,86,55,36,19,162,161,1
1856,2023,1,منطقة مكة المكرمة,النقل الجوي,متوسطة,3,122,95,27,119,119,0
1857,2023,1,منطقة نجران,النقل الجوي,متناهية الصغر,2,0,0,0,5,5,0
2081,2023,1,المنطقة الشرقية,التعليم,صغيرة,304,3867,1013,2854,2237,1963,274
2082,2023,1,المنطقة الشرقية,التعليم,كبيرة,14,4359,1931,2428,1222,1057,165
2083,2023,1,المنطقة الشرقية,التعليم,متناهية الصغر,371,388,153,235,490,442,48
2084,2023,1,المنطقة الشرقية,التعليم,متوسطة,95,5702,1795,3907,4338,3576,762
2085,2023,1,منطقة الباحة,التعليم,صغيرة,12,128,55,73,109,85,24
2086,2023,1,منطقة الباحة,التعليم,متناهية الصغر,15,13,3,10,23,20,3
2087,2023,1,منطقة الجوف,التعليم,صغيرة,35,534,226,308,275,248,27
2088,2023,1,منطقة الجوف,التعليم,متناهية الصغر,51,39,21,18,85,82,3
2089,2023,1,منطقة الجوف,التعليم,متوسطة,8,416,164,252,301,273,28
2090,2023,1,منطقة الحدود الشمالية,التعليم,صغيرة,18,200,142,58,147,141,6
2091,2023,1,منطقة الحدود الشمالية,التعليم,متناهية الصغر,23,24,5,19,32,32,0
2092,2023,1,منطقة الحدود الشمالية,التعليم,متوسطة,3,212,67,145,90,70,20
2093,2023,1,منطقة الرياض,التعليم,صغيرة,674,6515,1557,4958,5024,4189,835
2094,2023,1,منطقة الرياض,التعليم,كبيرة,48,17261,8117,9144,10351,8451,1900
2095,2023,1,منطقة الرياض,التعليم,متناهية الصغر,5750,1083,404,679,13456,13242,214
2096,2023,1,منطقة الرياض,التعليم,متوسطة,206,12921,3828,9093,9637,8058,1579
2097,2023,1,منطقة القصيم,التعليم,صغيرة,69,1045,271,774,354,314,40
2098,2023,1,منطقة القصيم,التعليم,كبيرة,2,365,127,238,309,213,96
2099,2023,1,منطقة القصيم,التعليم,متناهية الصغر,131,51,21,30,264,250,14
2100,2023,1,منطقة القصيم,التعليم,متوسطة,17,912,427,485,642,472,170
2101,2023,1,منطقة المدينة المنورة,التعليم,صغيرة,125,1644,319,1325,706,598,108
2102,2023,1,منطقة المدينة المنورة,التعليم,كبيرة,3,616,279,337,248,181,67
2103,2023,1,منطقة المدينة المنورة,التعليم,متناهية الصغر,146,139,38,101,203,189,14
2104,2023,1,منطقة المدينة المنورة,التعليم,متوسطة,35,2042,593,1449,1208,937,271
2105,2023,1,منطقة تبوك,التعليم,صغيرة,57,794,258,536,475,423,52
2106,2023,1,منطقة تبوك,التعليم,متناهية الصغر,37,32,6,26,43,41,2
2107,2023,1,منطقة تبوك,التعليم,متوسطة,19,1161,493,668,717,665,52
2108,2023,1,منطقة جازان,التعليم,صغيرة,56,382,100,282,320,284,36
2109,2023,1,منطقة جازان,التعليم,متناهية الصغر,91,71,10,61,139,131,8
2110,2023,1,منطقة جازان,التعليم,متوسطة,6,274,122,152,171,109,62
2111,2023,1,منطقة حائل,التعليم,صغيرة,35,359,77,282,142,125,17
2112,2023,1,منطقة حائل,التعليم,متناهية الصغر,114,40,12,28,264,262,2
2113,2023,1,منطقة حائل,التعليم,متوسطة,6,400,212,188,238,232,6
2114,2023,1,منطقة عسير,التعليم,صغيرة,80,1082,237,845,458,385,73
2115,2023,1,منطقة عسير,التعليم,متناهية الصغر,109,89,29,60,169,161,8
2116,2023,1,منطقة عسير,التعليم,متوسطة,20,916,534,382,686,624,62
2117,2023,1,منطقة مكة المكرمة,التعليم,صغيرة,402,5210,1060,4150,2556,1934,622
2118,2023,1,منطقة مكة المكرمة,التعليم,كبيرة,17,4408,1873,2535,2221,1387,834
2119,2023,1,منطقة مكة المكرمة,التعليم,متناهية الصغر,615,469,130,339,962,846,116
2120,2023,1,منطقة مكة المكرمة,التعليم,متوسطة,146,8685,3487,5198,6678,5292,1386
2121,2023,1,منطقة نجران,التعليم,صغيرة,21,275,53,222,135,127,8
2122,2023,1,منطقة نجران,التعليم,متناهية الصغر,94,26,9,17,199,197,2
2123,2023,1,منطقة نجران,التعليم,متوسطة,5,333,179,154,127,124,3
2166,2023,1,المنطقة الشرقية,البحث والتطوير في المجال العلمي,صغيرة,6,56,40,16,27,25,2
2167,2023,1,المنطقة الشرقية,البحث والتطوير في المجال العلمي,متناهية الصغر,18,23,11,12,25,25,0
2168,2023,1,المنطقة الشرقية,البحث والتطوير في المجال العلمي,متوسطة,2,133,79,54,137,131,6
2169,2023,1,منطقة الحدود الشمالية,البحث والتطوير في المجال العلمي,متناهية الصغر,1,1,1,0,0,0,0
2170,2023,1,منطقة الرياض,البحث والتطوير في المجال العلمي,صغيرة,34,274,142,132,198,168,30
2171,2023,1,منطقة الرياض,البحث والتطوير في المجال العلمي,متناهية الصغر,78,76,46,30,94,84,10
2172,2023,1,منطقة الرياض,البحث والتطوير في المجال العلمي,متوسطة,4,195,106,89,165,155,10
2173,2023,1,منطقة القصيم,البحث والتطوير في المجال العلمي,متناهية الصغر,2,0,0,0,4,4,0
2174,2023,1,منطقة المدينة المنورة,البحث والتطوير في المجال العلمي,صغيرة,1,5,4,1,3,3,0
2175,2023,1,منطقة المدينة المنورة,البحث والتطوير في المجال العلمي,متناهية الصغر,10,8,5,3,14,12,2
2176,2023,1,منطقة تبوك,البحث والتطوير في المجال العلمي,متناهية الصغر,1,0,0,0,1,1,0
2177,2023,1,منطقة جازان,البحث والتطوير في المجال العلمي,صغيرة,1,12,7,5,1,1,0
2178,2023,1,منطقة جازان,البحث والتطوير في المجال العلمي,متناهية الصغر,1,0,0,0,1,1,0
2179,2023,1,منطقة حائل,البحث والتطوير في المجال العلمي,متناهية الصغر,1,4,0,4,0,0,0
2180,2023,1,منطقة عسير,البحث والتطوير في المجال العلمي,صغيرة,3,24,3,21,5,5,0
2181,2023,1,منطقة عسير,البحث والتطوير في المجال العلمي,متناهية الصغر,2,2,0,2,3,2,1
2182,2023,1,منطقة مكة المكرمة,البحث والتطوير في المجال العلمي,صغيرة,12,77,44,33,94,88,6
2183,2023,1,منطقة مكة المكرمة,البحث والتطوير في المجال العلمي,كبيرة,1,1071,1064,7,49,49,0
2184,2023,1,منطقة مكة المكرمة,البحث والتطوير في المجال العلمي,متناهية الصغر,43,42,15,27,66,60,6
2185,2023,1,منطقة مكة المكرمة,البحث والتطوير في المجال العلمي,متوسطة,2,110,105,5,117,117,0
2241,2023,1,المنطقة الشرقية,الأنشطة القانونية وأنشطة المحاسبة,صغيرة,126,868,534,334,541,529,12
2242,2023,1,المنطقة الشرقية,الأنشطة القانونية وأنشطة المحاسبة,متناهية الصغر,301,440,269,171,281,272,9
2243,2023,1,المنطقة الشرقية,الأنشطة القانونية وأنشطة المحاسبة,متوسطة,9,443,265,178,294,288,6
2244,2023,1,منطقة الباحة,الأنشطة القانونية وأنشطة المحاسبة,صغيرة,1,10,0,10,7,1,6
2245,2023,1,منطقة الباحة,الأنشطة القانونية وأنشطة المحاسبة,متناهية الصغر,12,12,7,5,14,14,0
2246,2023,1,منطقة الجوف,الأنشطة القانونية وأنشطة المحاسبة,صغيرة,10,63,41,22,12,12,0
2247,2023,1,منطقة الجوف,الأنشطة القانونية وأنشطة المحاسبة,متناهية الصغر,31,38,21,17,25,25,0
2248,2023,1,منطقة الحدود الشمالية,الأنشطة القانونية وأنشطة المحاسبة,صغيرة,1,8,5,3,5,5,0
2249,2023,1,منطقة الحدود الشمالية,الأنشطة القانونية وأنشطة المحاسبة,متناهية الصغر,9,13,10,3,6,6,0
2250,2023,1,منطقة الرياض,الأنشطة القانونية وأنشطة المحاسبة,صغيرة,512,4025,2457,1568,2694,2573,121
2251,2023,1,منطقة الرياض,الأنشطة القانونية وأنشطة المحاسبة,كبيرة,3,758,421,337,795,741,54
2252,2023,1,منطقة الرياض,الأنشطة القانونية وأنشطة المحاسبة,متناهية الصغر,1591,1620,1032,588,2157,2115,42
2253,2023,1,منطقة الرياض,الأنشطة القانونية وأنشطة المحاسبة,متوسطة,26,1158,664,494,1143,1084,59
2254,2023,1,منطقة القصيم,الأنشطة القانونية وأنشطة المحاسبة,صغيرة,18,131,71,60,27,27,0
2255,2023,1,منطقة القصيم,الأنشطة القانونية وأنشطة المحاسبة,متناهية الصغر,85,115,65,50,72,71,1
2256,2023,1,منطقة المدينة المنورة,الأنشطة القانونية وأنشطة المحاسبة,صغيرة,30,253,150,103,109,107,2
2257,2023,1,منطقة المدينة المنورة,الأنشطة القانونية وأنشطة المحاسبة,متناهية الصغر,93,122,78,44,83,78,5
2258,2023,1,منطقة تبوك,الأنشطة القانونية وأنشطة المحاسبة,صغيرة,7,64,33,31,6,6,0
2259,2023,1,منطقة تبوك,الأنشطة القانونية وأنشطة المحاسبة,متناهية الصغر,25,27,7,20,21,21,0
2260,2023,1,منطقة جازان,الأنشطة القانونية وأنشطة المحاسبة,صغيرة,7,69,45,24,19,19,0
2261,2023,1,منطقة جازان,الأنشطة القانونية وأنشطة المحاسبة,متناهية الصغر,39,44,28,16,50,48,2
2262,2023,1,منطقة حائل,الأنشطة القانونية وأنشطة المحاسبة,صغيرة,4,30,29,1,15,15,0
2263,2023,1,منطقة حائل,الأنشطة القانونية وأنشطة المحاسبة,متناهية الصغر,35,43,28,15,29,27,2
2264,2023,1,منطقة عسير,الأنشطة القانونية وأنشطة المحاسبة,صغيرة,8,64,51,13,49,49,0
2265,2023,1,منطقة عسير,الأنشطة القانونية وأنشطة المحاسبة,متناهية الصغر,79,91,66,25,80,80,0
2266,2023,1,منطقة عسير,الأنشطة القانونية وأنشطة المحاسبة,متوسطة,2,70,36,34,82,82,0
2267,2023,1,منطقة مكة المكرمة,الأنشطة القانونية وأنشطة المحاسبة,صغيرة,309,2405,1529,876,1311,1243,68
2268,2023,1,منطقة مكة المكرمة,الأنشطة القانونية وأنشطة المحاسبة,كبيرة,1,163,57,106,122,118,4
2269,2023,1,منطقة مكة المكرمة,الأنشطة القانونية وأنشطة المحاسبة,متناهية الصغر,770,1064,658,406,718,672,46
2270,2023,1,منطقة مكة المكرمة,الأنشطة القانونية وأنشطة المحاسبة,متوسطة,13,929,552,377,803,776,27
2271,2023,1,منطقة نجران,الأنشطة القانونية وأنشطة المحاسبة,صغيرة,3,15,9,6,20,20,0
2272,2023,1,منطقة نجران,الأنشطة القانونية وأنشطة المحاسبة,متناهية الصغر,37,8,6,2,78,77,1
2273,2023,1,المنطقة الشرقية,الأنشطة العقارية,صغيرة,217,1289,759,530,1652,1630,22
2274,2023,1,المنطقة الشرقية,الأنشطة العقارية,كبيرة,2,156,56,100,607,607,0
2275,2023,1,المنطقة الشرقية,الأنشطة العقارية,متناهية الصغر,732,522,313,209,1070,1059,11
2276,2023,1,المنطقة الشرقية,الأنشطة العقارية,متوسطة,18,1060,702,358,968,949,19
2277,2023,1,منطقة الباحة,الأنشطة العقارية,صغيرة,3,19,18,1,21,21,0
2278,2023,1,منطقة الباحة,الأنشطة العقارية,متناهية الصغر,30,13,7,6,56,56,0
2279,2023,1,منطقة الجوف,الأنشطة العقارية,صغيرة,7,47,28,19,69,68,1
2280,2023,1,منطقة الجوف,الأنشطة العقارية,متناهية الصغر,55,30,15,15,89,87,2
2281,2023,1,منطقة الحدود الشمالية,الأنشطة العقارية,صغيرة,4,20,15,5,31,31,0
2282,2023,1,منطقة الحدود الشمالية,الأنشطة العقارية,متناهية الصغر,39,11,6,5,72,70,2
2283,2023,1,منطقة الرياض,الأنشطة العقارية,صغيرة,754,4871,2915,1956,6268,6130,138
2284,2023,1,منطقة الرياض,الأنشطة العقارية,كبيرة,9,2998,2055,943,1947,1893,54
2285,2023,1,منطقة الرياض,الأنشطة العقارية,متناهية الصغر,2286,1912,1150,762,3168,3118,50
2286,2023,1,منطقة الرياض,الأنشطة العقارية,متوسطة,61,3187,2268,919,2880,2819,61
2287,2023,1,منطقة القصيم,الأنشطة العقارية,صغيرة,28,184,113,71,210,209,1
2288,2023,1,منطقة القصيم,الأنشطة العقارية,كبيرة,1,51,30,21,214,214,0
2289,2023,1,منطقة القصيم,الأنشطة العقارية,متناهية الصغر,194,103,66,37,304,299,5
2290,2023,1,منطقة القصيم,الأنشطة العقارية,متوسطة,6,196,96,100,574,574,0
2291,2023,1,منطقة المدينة المنورة,الأنشطة العقارية,صغيرة,43,204,136,68,347,347,0
2292,2023,1,منطقة المدينة المنورة,الأنشطة العقارية,متناهية الصغر,300,132,82,50,510,503,7
2293,2023,1,منطقة المدينة المنورة,الأنشطة العقارية,متوسطة,4,131,89,42,238,232,6
2294,2023,1,منطقة تبوك,الأنشطة العقارية,صغيرة,10,53,39,14,111,110,1
2295,2023,1,منطقة تبوك,الأنشطة العقارية,متناهية الصغر,132,51,33,18,211,211,0
2296,2023,1,منطقة جازان,الأنشطة العقارية,صغيرة,15,32,13,19,149,148,1
2297,2023,1,منطقة جازان,الأنشطة العقارية,متناهية الصغر,169,64,33,31,280,278,2
2298,2023,1,منطقة جازان,الأنشطة العقارية,متوسطة,1,24,12,12,30,30,0
2299,2023,1,منطقة حائل,الأنشطة العقارية,صغيرة,10,53,40,13,72,72,0
2300,2023,1,منطقة حائل,الأنشطة العقارية,متناهية الصغر,89,38,20,18,142,142,0
2301,2023,1,منطقة حائل,الأنشطة العقارية,متوسطة,1,0,0,0,59,59,0
2302,2023,1,منطقة عسير,الأنشطة العقارية,صغيرة,35,126,87,39,241,241,0
2303,2023,1,منطقة عسير,الأنشطة العقارية,متناهية الصغر,295,128,73,55,467,463,4
2304,2023,1,منطقة عسير,الأنشطة العقارية,متوسطة,4,73,41,32,252,251,1
2305,2023,1,منطقة مكة المكرمة,الأنشطة العقارية,صغيرة,457,2392,1373,1019,3922,3809,113
2306,2023,1,منطقة مكة المكرمة,الأنشطة العقارية,كبيرة,3,927,511,416,553,531,22
2307,2023,1,منطقة مكة المكرمة,الأنشطة العقارية,متناهية الصغر,1951,1174,683,491,3076,2998,78
2308,2023,1,منطقة مكة المكرمة,الأنشطة العقارية,متوسطة,40,1518,1094,424,2331,2253,78
2309,2023,1,منطقة نجران,الأنشطة العقارية,صغيرة,7,31,16,15,63,63,0
2310,2023,1,منطقة نجران,الأنشطة العقارية,متناهية الصغر,66,9,6,3,118,117,1
2311,2023,1,المنطقة الشرقية,الأنشطة الرياضية وأنشطة التسلية والترفيه,صغيرة,145,579,232,347,1221,1023,198
2312,2023,1,المنطقة الشرقية,الأنشطة الرياضية وأنشطة التسلية والترفيه,متناهية الصغر,319,265,88,177,478,429,49
2313,2023,1,المنطقة الشرقية,الأنشطة الرياضية وأنشطة التسلية والترفيه,متوسطة,8,282,99,183,436,425,11
2314,2023,1,منطقة الباحة,الأنشطة الرياضية وأنشطة التسلية والترفيه,صغيرة,2,7,4,3,11,11,0
2315,2023,1,منطقة الباحة,الأنشطة الرياضية وأنشطة التسلية والترفيه,متناهية الصغر,30,23,11,12,57,50,7
2316,2023,1,منطقة الجوف,الأنشطة الرياضية وأنشطة التسلية والترفيه,صغيرة,10,45,24,21,60,60,0
2317,2023,1,منطقة الجوف,الأنشطة الرياضية وأنشطة التسلية والترفيه,متناهية الصغر,39,15,6,9,69,63,6
2318,2023,1,منطقة الحدود الشمالية,الأنشطة الرياضية وأنشطة التسلية والترفيه,صغيرة,9,29,10,19,69,56,13
2319,2023,1,منطقة الحدود الشمالية,الأنشطة الرياضية وأنشطة التسلية والترفيه,متناهية الصغر,47,17,8,9,97,88,9
2320,2023,1,منطقة الرياض,الأنشطة الرياضية وأنشطة التسلية والترفيه,صغيرة,278,1411,519,892,2613,2251,362
2321,2023,1,منطقة الرياض,الأنشطة الرياضية وأنشطة التسلية والترفيه,كبيرة,6,1438,867,571,1900,1532,368
2322,2023,1,منطقة الرياض,الأنشطة الرياضية وأنشطة التسلية والترفيه,متناهية الصغر,768,474,155,319,1359,1242,117
2323,2023,1,منطقة الرياض,الأنشطة الرياضية وأنشطة التسلية والترفيه,متوسطة,29,1331,447,884,1516,1225,291
2324,2023,1,منطقة القصيم,الأنشطة الرياضية وأنشطة التسلية والترفيه,صغيرة,49,233,103,130,361,329,32
2325,2023,1,منطقة القصيم,الأنشطة الرياضية وأنشطة التسلية والترفيه,متناهية الصغر,75,67,30,37,103,89,14
2326,2023,1,منطقة القصيم,الأنشطة الرياضية وأنشطة التسلية والترفيه,متوسطة,1,60,12,48,155,155,0
2327,2023,1,منطقة المدينة المنورة,الأنشطة الرياضية وأنشطة التسلية والترفيه,صغيرة,37,181,59,122,268,247,21
2328,2023,1,منطقة المدينة المنورة,الأنشطة الرياضية وأنشطة التسلية والترفيه,متناهية الصغر,102,83,33,50,164,143,21
2329,2023,1,منطقة المدينة المنورة,الأنشطة الرياضية وأنشطة التسلية والترفيه,متوسطة,2,85,37,48,124,113,11
2330,2023,1,منطقة تبوك,الأنشطة الرياضية وأنشطة التسلية والترفيه,صغيرة,25,101,33,68,150,130,20
2331,2023,1,منطقة تبوك,الأنشطة الرياضية وأنشطة التسلية والترفيه,متناهية الصغر,76,36,11,25,133,125,8
2332,2023,1,منطقة جازان,الأنشطة الرياضية وأنشطة التسلية والترفيه,صغيرة,12,35,9,26,177,161,16
2333,2023,1,منطقة جازان,الأنشطة الرياضية وأنشطة التسلية والترفيه,متناهية الصغر,69,43,14,29,102,88,14
2334,2023,1,منطقة جازان,الأنشطة الرياضية وأنشطة التسلية والترفيه,متوسطة,3,33,18,15,195,195,0
2335,2023,1,منطقة حائل,الأنشطة الرياضية وأنشطة التسلية والترفيه,صغيرة,23,85,35,50,203,201,2
2336,2023,1,منطقة حائل,الأنشطة الرياضية وأنشطة التسلية والترفيه,متناهية الصغر,60,39,21,18,107,102,5
2337,2023,1,منطقة عسير,الأنشطة الرياضية وأنشطة التسلية والترفيه,صغيرة,65,285,81,204,568,499,69
2338,2023,1,منطقة عسير,الأنشطة الرياضية وأنشطة التسلية والترفيه,متناهية الصغر,145,88,35,53,249,236,13
2339,2023,1,منطقة مكة المكرمة,الأنشطة الرياضية وأنشطة التسلية والترفيه,صغيرة,199,1023,384,639,1514,1293,221
2340,2023,1,منطقة مكة المكرمة,الأنشطة الرياضية وأنشطة التسلية والترفيه,كبيرة,1,140,76,64,166,109,57
2341,2023,1,منطقة مكة المكرمة,الأنشطة الرياضية وأنشطة التسلية والترفيه,متناهية الصغر,605,383,154,229,1064,966,98
2342,2023,1,منطقة مكة المكرمة,الأنشطة الرياضية وأنشطة التسلية والترفيه,متوسطة,25,1257,490,767,1272,1147,125
2343,2023,1,منطقة نجران,الأنشطة الرياضية وأنشطة التسلية والترفيه,صغيرة,16,68,38,30,117,113,4
2344,2023,1,منطقة نجران,الأنشطة الرياضية وأنشطة التسلية والترفيه,متناهية الصغر,41,22,13,9,87,81,6
2345,2023,1,المنطقة الشرقية,الأنشطة البيطرية,صغيرة,13,65,25,40,137,129,8
2346,2023,1,المنطقة الشرقية,الأنشطة البيطرية,متناهية الصغر,50,30,15,15,84,77,7
2347,2023,1,منطقة الباحة,الأنشطة البيطرية,متناهية الصغر,2,1,0,1,2,2,0
2348,2023,1,منطقة الجوف,الأنشطة البيطرية,متناهية الصغر,1,0,0,0,3,3,0
2349,2023,1,منطقة الحدود الشمالية,الأنشطة البيطرية,متناهية الصغر,5,3,2,1,10,10,0
2350,2023,1,منطقة الرياض,الأنشطة البيطرية,صغيرة,35,161,65,96,324,283,41
2351,2023,1,منطقة الرياض,الأنشطة البيطرية,متناهية الصغر,83,50,17,33,144,138,6
2352,2023,1,منطقة الرياض,الأنشطة البيطرية,متوسطة,3,89,40,49,124,115,9
2353,2023,1,منطقة القصيم,الأنشطة البيطرية,صغيرة,3,11,9,2,10,10,0
2354,2023,1,منطقة القصيم,الأنشطة البيطرية,متناهية الصغر,19,5,2,3,33,31,2
2355,2023,1,منطقة القصيم,الأنشطة البيطرية,متوسطة,1,31,31,0,55,55,0
2356,2023,1,منطقة المدينة المنورة,الأنشطة البيطرية,صغيرة,4,15,4,11,22,17,5
2357,2023,1,منطقة المدينة المنورة,الأنشطة البيطرية,متناهية الصغر,17,2,1,1,31,30,1
2358,2023,1,منطقة تبوك,الأنشطة البيطرية,صغيرة,2,7,1,6,17,16,1
2359,2023,1,منطقة تبوك,الأنشطة البيطرية,متناهية الصغر,8,7,6,1,14,14,0
2360,2023,1,منطقة جازان,الأنشطة البيطرية,متناهية الصغر,7,4,2,2,14,14,0
2361,2023,1,منطقة حائل,الأنشطة البيطرية,صغيرة,1,1,0,1,6,6,0
2362,2023,1,منطقة حائل,الأنشطة البيطرية,متناهية الصغر,7,0,0,0,14,13,1
2363,2023,1,منطقة عسير,الأنشطة البيطرية,صغيرة,3,7,5,2,27,24,3
2364,2023,1,منطقة عسير,الأنشطة البيطرية,متناهية الصغر,33,6,2,4,54,53,1
2365,2023,1,منطقة مكة المكرمة,الأنشطة البيطرية,صغيرة,20,98,23,75,181,156,25
2366,2023,1,منطقة مكة المكرمة,الأنشطة البيطرية,متناهية الصغر,56,23,8,15,101,96,5
2367,2023,1,منطقة مكة المكرمة,الأنشطة البيطرية,متوسطة,1,19,6,13,45,38,7
2368,2023,1,منطقة نجران,الأنشطة البيطرية,متناهية الصغر,11,2,1,1,17,17,0
2573,2023,1,المنطقة الشرقية,الاتصالات,صغيرة,27,201,142,59,245,240,5
2574,2023,1,المنطقة الشرقية,الاتصالات,متناهية الصغر,98,61,35,26,157,155,2
2575,2023,1,المنطقة الشرقية,الاتصالات,متوسطة,2,91,84,7,50,50,0
2576,2023,1,منطقة الباحة,الاتصالات,صغيرة,1,3,1,2,6,6,0
2577,2023,1,منطقة الباحة,الاتصالات,متناهية الصغر,3,3,3,0,3,3,0
2578,2023,1,منطقة الجوف,الاتصالات,متناهية الصغر,15,7,3,4,22,22,0
2579,2023,1,منطقة الحدود الشمالية,الاتصالات,متناهية الصغر,13,4,0,4,28,27,1
2580,2023,1,منطقة الرياض,الاتصالات,صغيرة,128,863,386,477,1365,1300,65
2581,2023,1,منطقة الرياض,الاتصالات,كبيرة,12,19729,15214,4515,2735,2679,56
2582,2023,1,منطقة الرياض,الاتصالات,متناهية الصغر,348,190,106,84,641,633,8
2583,2023,1,منطقة الرياض,الاتصالات,متوسطة,30,2045,1330,715,1265,1229,36
2584,2023,1,منطقة القصيم,الاتصالات,صغيرة,5,28,10,18,51,51,0
2585,2023,1,منطقة القصيم,الاتصالات,متناهية الصغر,57,16,10,6,106,106,0
2586,2023,1,منطقة المدينة المنورة,الاتصالات,صغيرة,3,16,5,11,6,6,0
2587,2023,1,منطقة المدينة المنورة,الاتصالات,متناهية الصغر,31,11,8,3,57,57,0
2588,2023,1,منطقة تبوك,الاتصالات,صغيرة,1,2,1,1,5,5,0
2589,2023,1,منطقة تبوك,الاتصالات,متناهية الصغر,16,6,4,2,19,19,0
2590,2023,1,منطقة جازان,الاتصالات,صغيرة,2,2,2,0,12,12,0
2591,2023,1,منطقة جازان,الاتصالات,متناهية الصغر,21,4,3,1,36,36,0
2592,2023,1,منطقة حائل,الاتصالات,صغيرة,1,0,0,0,9,9,0
2593,2023,1,منطقة حائل,الاتصالات,متناهية الصغر,17,9,2,7,30,28,2
2594,2023,1,منطقة عسير,الاتصالات,صغيرة,3,6,4,2,14,14,0
2595,2023,1,منطقة عسير,الاتصالات,متناهية الصغر,43,17,12,5,68,67,1
2596,2023,1,منطقة مكة المكرمة,الاتصالات,صغيرة,31,235,102,133,292,282,10
2597,2023,1,منطقة مكة المكرمة,الاتصالات,متناهية الصغر,236,82,47,35,397,391,6
2598,2023,1,منطقة مكة المكرمة,الاتصالات,متوسطة,1,73,71,2,29,29,0
2599,2023,1,منطقة نجران,الاتصالات,صغيرة,1,0,0,0,11,11,0
2600,2023,1,منطقة نجران,الاتصالات,متناهية الصغر,11,1,1,0,25,25,0
