year,quarter,region,economic_activity,facility_size,no_of_faicility,saudi_employees,male_saudies,female_saudies,foreign_employees,male_foreigners,female_foreigners
2023,1,المنطقة الشرقية,الخدمات,صغيرة,54,320,137,183,523,516,7
2023,1,المنطقة الشرقية,الخدمات,كبيرة,1,221,207,14,213,212,1
2023,1,المنطقة الشرقية,الخدمات,متناهية الصغر,184,122,65,57,287,285,2
2023,1,المنطقة الشرقية,الخدمات,متوسطة,6,239,130,109,329,326,3
2023,1,منطقة الباحة,الخدمات,متناهية الصغر,7,2,2,0,13,13,0
2023,1,منطقة الجوف,الخدمات,صغيرة,3,12,8,4,23,23,0
2023,1,منطقة الجوف,الخدمات,متناهية الصغر,17,6,2,4,33,33,0
2023,1,منطقة الحدود الشمالية,الخدمات,صغيرة,1,4,4,0,26,26,0
2023,1,منطقة الحدود الشمالية,الخدمات,متناهية الصغر,12,2,2,0,26,26,0
2023,1,منطقة الرياض,الخدمات,صغيرة,159,898,365,533,1322,1287,35
2023,1,منطقة الرياض,الخدمات,كبيرة,2,312,187,125,319,313,6
2023,1,منطقة الرياض,الخدمات,متناهية الصغر,411,226,98,128,738,712,26
2023,1,منطقة الرياض,الخدمات,متوسطة,18,681,364,317,1046,1035,11
2023,1,منطقة القصيم,الخدمات,صغيرة,13,31,16,15,94,92,2
2023,1,منطقة القصيم,الخدمات,متناهية الصغر,80,24,11,13,158,157,1
2023,1,منطقة المدينة المنورة,الخدمات,صغيرة,28,134,58,76,254,249,5
2023,1,منطقة المدينة المنورة,الخدمات,متناهية الصغر,145,84,47,37,233,225,8
2023,1,منطقة تبوك,الخدمات,صغيرة,7,30,19,11,75,75,0
2023,1,منطقة تبوك,الخدمات,متناهية الصغر,40,16,7,9,67,64,3
2023,1,منطقة جازان,الخدمات,صغيرة,2,9,2,7,17,17,0
2023,1,منطقة جازان,الخدمات,متناهية الصغر,26,15,6,9,41,41,0
2023,1,منطقة حائل,الخدمات,صغيرة,8,31,12,19,67,65,2
2023,1,منطقة حائل,الخدمات,متناهية الصغر,20,10,8,2,42,42,0
2023,1,منطقة عسير,الخدمات,صغيرة,2,11,4,7,19,19,0
2023,1,منطقة عسير,الخدمات,متناهية الصغر,59,32,17,15,113,113,0
2023,1,منطقة مكة المكرمة,الخدمات,صغيرة,200,846,500,346,1635,1603,32
2023,1,منطقة مكة المكرمة,الخدمات,كبيرة,1,249,240,9,32,31,1
2023,1,منطقة مكة المكرمة,الخدمات,متناهية الصغر,721,490,295,195,1230,1198,32
2023,1,منطقة مكة المكرمة,الخدمات,متوسطة,12,581,319,262,545,542,3
2023,1,منطقة نجران,الخدمات,صغيرة,4,6,3,3,29,29,0
2023,1,منطقة نجران,الخدمات,متناهية الصغر,15,9,5,4,28,28,0
2023,1,المنطقة الشرقية,صيد الأسماك وتربية المائيات,صغيرة,138,122,47,75,1229,1228,1
2023,1,المنطقة الشرقية,صيد الأسماك وتربية المائيات,متناهية الصغر,2055,183,82,101,5887,5873,14
2023,1,منطقة الباحة,صيد الأسماك وتربية المائيات,صغيرة,2,0,0,0,13,13,0
2023,1,منطقة الباحة,صيد الأسماك وتربية المائيات,متناهية الصغر,131,9,5,4,370,370,0
2023,1,منطقة الجوف,صيد الأسماك وتربية المائيات,صغيرة,3,5,1,4,13,13,0
2023,1,منطقة الجوف,صيد الأسماك وتربية المائيات,متناهية الصغر,609,43,27,16,1301,1293,8
2023,1,منطقة الحدود الشمالية,صيد الأسماك وتربية المائيات,صغيرة,1,3,1,2,16,16,0
2023,1,منطقة الحدود الشمالية,صيد الأسماك وتربية المائيات,متناهية الصغر,222,19,11,8,643,642,1
2023,1,منطقة الرياض,صيد الأسماك وتربية المائيات,صغيرة,847,612,289,323,5813,5782,31
2023,1,منطقة الرياض,صيد الأسماك وتربية المائيات,متناهية الصغر,107429,8541,4149,4392,320241,318328,1913
2023,1,منطقة الرياض,صيد الأسماك وتربية المائيات,متوسطة,4,98,23,75,294,294,0
2023,1,منطقة القصيم,صيد الأسماك وتربية المائيات,صغيرة,22,14,6,8,166,165,1
2023,1,منطقة القصيم,صيد الأسماك وتربية المائيات,متناهية الصغر,2705,206,92,114,8079,8062,17
2023,1,منطقة المدينة المنورة,صيد الأسماك وتربية المائيات,صغيرة,28,21,14,7,256,256,0
2023,1,منطقة المدينة المنورة,صيد الأسماك وتربية المائيات,متناهية الصغر,1220,108,67,41,3241,3162,79
2023,1,منطقة تبوك,صيد الأسماك وتربية المائيات,صغيرة,21,2,0,2,205,205,0
2023,1,منطقة تبوك,صيد الأسماك وتربية المائيات,متناهية الصغر,469,38,18,20,1192,1188,4
2023,1,منطقة جازان,صيد الأسماك وتربية المائيات,صغيرة,59,87,61,26,675,674,1
2023,1,منطقة جازان,صيد الأسماك وتربية المائيات,متناهية الصغر,963,67,32,35,2357,2336,21
2023,1,منطقة جازان,صيد الأسماك وتربية المائيات,متوسطة,3,37,23,14,329,328,1
2023,1,منطقة حائل,صيد الأسماك وتربية المائيات,صغيرة,25,8,4,4,156,156,0
2023,1,منطقة حائل,صيد الأسماك وتربية المائيات,متناهية الصغر,5042,324,147,177,14732,14698,34
2023,1,منطقة عسير,صيد الأسماك وتربية المائيات,صغيرة,32,42,32,10,246,246,0
2023,1,منطقة عسير,صيد الأسماك وتربية المائيات,متناهية الصغر,1100,61,27,34,2510,2499,11
2023,1,منطقة عسير,صيد الأسماك وتربية المائيات,متوسطة,1,6,2,4,44,44,0
2023,1,منطقة مكة المكرمة,صيد الأسماك وتربية المائيات,صغيرة,111,78,42,36,844,839,5
2023,1,منطقة مكة المكرمة,صيد الأسماك وتربية المائيات,كبيرة,1,271,248,23,2028,2025,3
2023,1,منطقة مكة المكرمة,صيد الأسماك وتربية المائيات,متناهية الصغر,6265,496,256,240,16053,15518,535
2023,1,منطقة مكة المكرمة,صيد الأسماك وتربية المائيات,متوسطة,2,31,30,1,248,248,0
2023,1,منطقة نجران,صيد الأسماك وتربية المائيات,صغيرة,20,11,2,9,140,140,0
2023,1,منطقة نجران,صيد الأسماك وتربية المائيات,متناهية الصغر,2197,141,69,72,6365,6351,14
2023,1,المنطقة الشرقية,الصناعة,صغيرة,667,1957,1141,816,7591,7582,9
2023,1,المنطقة الشرقية,الصناعة,كبيرة,23,7051,6345,706,6473,6462,11
2023,1,المنطقة الشرقية,الصناعة,متناهية الصغر,1486,452,244,208,3397,3395,2
2023,1,المنطقة الشرقية,الصناعة,متوسطة,111,3037,2190,847,8358,8348,10
2023,1,منطقة الباحة,الصناعة,صغيرة,21,23,13,10,120,120,0
2023,1,منطقة الباحة,الصناعة,متناهية الصغر,327,50,34,16,661,661,0
2023,1,منطقة الجوف,الصناعة,صغيرة,28,35,24,11,239,239,0
2023,1,منطقة الجوف,الصناعة,متناهية الصغر,311,29,25,4,698,697,1
2023,1,منطقة الحدود الشمالية,الصناعة,صغيرة,19,35,19,16,225,225,0
2023,1,منطقة الحدود الشمالية,الصناعة,متناهية الصغر,121,17,6,11,293,290,3
2023,1,منطقة الرياض,الصناعة,صغيرة,963,3064,1267,1797,12531,12482,49
2023,1,منطقة الرياض,الصناعة,كبيرة,18,2327,1442,885,6480,6457,23
2023,1,منطقة الرياض,الصناعة,متناهية الصغر,2666,632,291,341,6043,6014,29
2023,1,منطقة الرياض,الصناعة,متوسطة,174,4104,2067,2037,13034,13007,27
2023,1,منطقة القصيم,الصناعة,صغيرة,169,336,190,146,1632,1630,2
2023,1,منطقة القصيم,الصناعة,كبيرة,1,117,96,21,376,376,0
2023,1,منطقة القصيم,الصناعة,متناهية الصغر,1240,185,104,81,2973,2968,5
2023,1,منطقة القصيم,الصناعة,متوسطة,9,164,101,63,654,653,1
2023,1,منطقة المدينة المنورة,الصناعة,صغيرة,97,198,91,107,974,973,1
2023,1,منطقة المدينة المنورة,الصناعة,متناهية الصغر,667,114,66,48,1543,1541,2
2023,1,منطقة المدينة المنورة,الصناعة,متوسطة,9,337,219,118,748,746,2
2023,1,منطقة تبوك,الصناعة,صغيرة,33,70,42,28,360,359,1
2023,1,منطقة تبوك,الصناعة,متناهية الصغر,227,40,22,18,562,561,1
2023,1,منطقة تبوك,الصناعة,متوسطة,2,43,21,22,117,116,1
2023,1,منطقة جازان,الصناعة,صغيرة,42,91,57,34,361,360,1
2023,1,منطقة جازان,الصناعة,متناهية الصغر,844,87,51,36,2073,2071,2
2023,1,منطقة جازان,الصناعة,متوسطة,1,15,5,10,41,41,0
2023,1,منطقة حائل,الصناعة,صغيرة,56,112,42,70,600,600,0
2023,1,منطقة حائل,الصناعة,متناهية الصغر,238,45,21,24,528,525,3
2023,1,منطقة حائل,الصناعة,متوسطة,2,55,37,18,66,66,0
2023,1,منطقة عسير,الصناعة,صغيرة,90,231,130,101,921,921,0
2023,1,منطقة عسير,الصناعة,متناهية الصغر,1111,159,82,77,2565,2565,0
2023,1,منطقة عسير,الصناعة,متوسطة,8,109,57,52,513,513,0
2023,1,منطقة مكة المكرمة,الصناعة,صغيرة,374,1042,514,528,4484,4455,29
2023,1,منطقة مكة المكرمة,الصناعة,كبيرة,9,930,679,251,2426,2420,6
2023,1,منطقة مكة المكرمة,الصناعة,متناهية الصغر,2173,328,178,150,5128,5113,15
2023,1,منطقة مكة المكرمة,الصناعة,متوسطة,77,2245,1563,682,6498,6476,22
2023,1,منطقة نجران,الصناعة,صغيرة,14,14,4,10,101,101,0
2023,1,منطقة نجران,الصناعة,متناهية الصغر,343,33,14,19,839,837,2
2023,1,منطقة نجران,الصناعة,متوسطة,1,7,3,4,44,44,0
2023,1,المنطقة الشرقية,الصناعة,صغيرة,296,1070,606,464,4687,4684,3
2023,1,المنطقة الشرقية,الصناعة,كبيرة,16,2176,1684,492,5396,5392,4
2023,1,المنطقة الشرقية,الصناعة,متناهية الصغر,377,128,77,51,902,899,3
2023,1,المنطقة الشرقية,الصناعة,متوسطة,139,3245,2010,1235,10389,10328,61
2023,1,منطقة الباحة,الصناعة,صغيرة,27,122,73,49,515,515,0
2023,1,منطقة الباحة,الصناعة,متناهية الصغر,43,13,11,2,87,87,0
2023,1,منطقة الباحة,الصناعة,متوسطة,7,120,68,52,438,434,4
2023,1,منطقة الجوف,الصناعة,صغيرة,31,103,60,43,415,414,1
2023,1,منطقة الجوف,الصناعة,متناهية الصغر,39,3,3,0,85,84,1
2023,1,منطقة الجوف,الصناعة,متوسطة,15,297,214,83,1084,1084,0
2023,1,منطقة الحدود الشمالية,الصناعة,صغيرة,21,58,31,27,302,302,0
2023,1,منطقة الحدود الشمالية,الصناعة,كبيرة,1,215,213,2,184,184,0
2023,1,منطقة الحدود الشمالية,الصناعة,متناهية الصغر,36,9,6,3,84,84,0
2023,1,منطقة الحدود الشمالية,الصناعة,متوسطة,4,93,51,42,269,268,1
2023,1,منطقة الرياض,الصناعة,صغيرة,1390,2186,962,1224,23976,23862,114
2023,1,منطقة الرياض,الصناعة,كبيرة,38,5463,3622,1841,12515,12489,26
2023,1,منطقة الرياض,الصناعة,متناهية الصغر,1781,307,160,147,4621,4585,36
2023,1,منطقة الرياض,الصناعة,متوسطة,373,5217,2547,2670,27579,27525,54
2023,1,منطقة القصيم,الصناعة,صغيرة,167,437,255,182,2840,2836,4
2023,1,منطقة القصيم,الصناعة,كبيرة,8,903,737,166,2554,2553,1
2023,1,منطقة القصيم,الصناعة,متناهية الصغر,273,49,31,18,711,710,1
2023,1,منطقة القصيم,الصناعة,متوسطة,44,955,548,407,3337,3337,0
2023,1,منطقة المدينة المنورة,الصناعة,صغيرة,101,262,167,95,1416,1414,2
2023,1,منطقة المدينة المنورة,الصناعة,كبيرة,7,1155,795,360,2491,2488,3
2023,1,منطقة المدينة المنورة,الصناعة,متناهية الصغر,174,37,27,10,410,402,8
2023,1,منطقة المدينة المنورة,الصناعة,متوسطة,42,1046,753,293,3748,3744,4
2023,1,منطقة تبوك,الصناعة,صغيرة,30,113,63,50,374,370,4
2023,1,منطقة تبوك,الصناعة,كبيرة,2,381,353,28,533,533,0
2023,1,منطقة تبوك,الصناعة,متناهية الصغر,50,17,9,8,112,112,0
2023,1,منطقة تبوك,الصناعة,متوسطة,8,221,145,76,694,694,0
2023,1,منطقة جازان,الصناعة,صغيرة,73,198,115,83,1085,1083,2
2023,1,منطقة جازان,الصناعة,كبيرة,2,433,418,15,343,343,0
2023,1,منطقة جازان,الصناعة,متناهية الصغر,141,28,20,8,338,337,1
2023,1,منطقة جازان,الصناعة,متوسطة,31,683,417,266,2013,2013,0
2023,1,منطقة حائل,الصناعة,صغيرة,40,68,37,31,489,489,0
2023,1,منطقة حائل,الصناعة,كبيرة,1,254,254,0,164,163,1
2023,1,منطقة حائل,الصناعة,متناهية الصغر,137,25,17,8,324,324,0
2023,1,منطقة حائل,الصناعة,متوسطة,11,201,120,81,945,945,0
2023,1,منطقة عسير,الصناعة,صغيرة,159,518,324,194,2339,2331,8
2023,1,منطقة عسير,الصناعة,كبيرة,6,1082,836,246,1727,1726,1
2023,1,منطقة عسير,الصناعة,متناهية الصغر,292,63,33,30,751,746,5
2023,1,منطقة عسير,الصناعة,متوسطة,45,971,574,397,3336,3335,1
2023,1,منطقة مكة المكرمة,الصناعة,صغيرة,268,778,389,389,3742,3728,14
2023,1,منطقة مكة المكرمة,الصناعة,كبيرة,16,2973,1981,992,6085,6078,7
2023,1,منطقة مكة المكرمة,الصناعة,متناهية الصغر,511,150,85,65,1234,1224,10
2023,1,منطقة مكة المكرمة,الصناعة,متوسطة,101,2289,1358,931,7804,7794,10
2023,1,منطقة نجران,الصناعة,صغيرة,35,89,41,48,502,501,1
2023,1,منطقة نجران,الصناعة,كبيرة,1,344,326,18,423,423,0
2023,1,منطقة نجران,الصناعة,متناهية الصغر,77,13,7,6,203,203,0
2023,1,منطقة نجران,الصناعة,متوسطة,25,526,289,237,1809,1804,5
2023,1,المنطقة الشرقية,الصناعة,صغيرة,66,276,177,99,1012,1011,1
2023,1,المنطقة الشرقية,الصناعة,كبيرة,3,423,404,19,885,885,0
2023,1,المنطقة الشرقية,الصناعة,متناهية الصغر,53,36,15,21,117,117,0
2023,1,المنطقة الشرقية,الصناعة,متوسطة,36,1051,783,268,2635,2629,6
2023,1,منطقة الباحة,الصناعة,متناهية الصغر,2,0,0,0,5,5,0
2023,1,منطقة الجوف,الصناعة,صغيرة,2,15,8,7,31,31,0
2023,1,منطقة الجوف,الصناعة,كبيرة,1,118,82,36,382,382,0
2023,1,منطقة الجوف,الصناعة,متناهية الصغر,14,2,1,1,37,37,0
2023,1,منطقة الحدود الشمالية,الصناعة,صغيرة,1,3,1,2,6,6,0
2023,1,منطقة الحدود الشمالية,الصناعة,متناهية الصغر,1,0,0,0,1,1,0
2023,1,منطقة الرياض,الصناعة,صغيرة,144,668,283,385,2598,2583,15
2023,1,منطقة الرياض,الصناعة,كبيرة,10,926,462,464,3184,3179,5
2023,1,منطقة الرياض,الصناعة,متناهية الصغر,221,74,35,39,546,537,9
2023,1,منطقة الرياض,الصناعة,متوسطة,93,2553,1325,1228,7828,7816,12
2023,1,منطقة القصيم,الصناعة,صغيرة,4,21,7,14,61,61,0
2023,1,منطقة القصيم,الصناعة,متناهية الصغر,18,6,1,5,31,30,1
2023,1,منطقة القصيم,الصناعة,متوسطة,8,255,160,95,654,653,1
2023,1,منطقة المدينة المنورة,الصناعة,صغيرة,25,130,68,62,511,511,0
2023,1,منطقة المدينة المنورة,الصناعة,كبيرة,1,127,63,64,333,333,0
2023,1,منطقة المدينة المنورة,الصناعة,متناهية الصغر,22,11,5,6,31,31,0
2023,1,منطقة المدينة المنورة,الصناعة,متوسطة,8,232,144,88,681,677,4
2023,1,منطقة تبوك,الصناعة,صغيرة,7,30,16,14,98,98,0
2023,1,منطقة تبوك,الصناعة,متناهية الصغر,4,3,1,2,8,8,0
2023,1,منطقة تبوك,الصناعة,متوسطة,1,20,12,8,77,77,0
2023,1,منطقة جازان,الصناعة,صغيرة,1,2,1,1,8,8,0
2023,1,منطقة جازان,الصناعة,متناهية الصغر,8,1,1,0,27,27,0
2023,1,منطقة حائل,الصناعة,صغيرة,3,19,10,9,55,55,0
2023,1,منطقة حائل,الصناعة,متناهية الصغر,5,0,0,0,11,11,0
2023,1,منطقة حائل,الصناعة,متوسطة,2,109,83,26,149,149,0
2023,1,منطقة عسير,الصناعة,صغيرة,7,22,11,11,85,85,0
2023,1,منطقة عسير,الصناعة,متناهية الصغر,25,9,4,5,50,50,0
2023,1,منطقة عسير,الصناعة,متوسطة,4,80,45,35,237,237,0
2023,1,منطقة مكة المكرمة,الصناعة,صغيرة,86,446,231,215,1561,1551,10
2023,1,منطقة مكة المكرمة,الصناعة,كبيرة,12,1419,1072,347,3148,3134,14
2023,1,منطقة مكة المكرمة,الصناعة,متناهية الصغر,77,33,23,10,169,168,1
2023,1,منطقة مكة المكرمة,الصناعة,متوسطة,34,852,407,445,2976,2973,3
2023,1,منطقة نجران,الصناعة,صغيرة,3,19,10,9,66,66,0
2023,1,منطقة نجران,الصناعة,متناهية الصغر,11,4,3,1,33,33,0
2023,1,منطقة نجران,الصناعة,متوسطة,3,53,18,35,244,244,0
2023,1,المنطقة الشرقية,الصناعة,صغيرة,26,145,93,52,467,467,0
2023,1,المنطقة الشرقية,الصناعة,كبيرة,8,4165,4105,60,1618,1617,1
2023,1,المنطقة الشرقية,الصناعة,متناهية الصغر,11,8,4,4,18,17,1
2023,1,المنطقة الشرقية,الصناعة,متوسطة,7,523,506,17,633,633,0
2023,1,منطقة الرياض,الصناعة,صغيرة,33,193,114,79,428,425,3
2023,1,منطقة الرياض,الصناعة,متناهية الصغر,38,33,19,14,60,59,1
2023,1,منطقة الرياض,الصناعة,متوسطة,5,163,112,51,346,346,0
2023,1,منطقة القصيم,الصناعة,صغيرة,4,27,24,3,77,77,0
2023,1,منطقة القصيم,الصناعة,متناهية الصغر,3,1,1,0,7,7,0
2023,1,منطقة المدينة المنورة,الصناعة,صغيرة,2,16,15,1,34,34,0
2023,1,منطقة المدينة المنورة,الصناعة,كبيرة,4,2073,2008,65,498,498,0
2023,1,منطقة المدينة المنورة,الصناعة,متناهية الصغر,5,5,3,2,9,9,0
2023,1,منطقة المدينة المنورة,الصناعة,متوسطة,4,203,199,4,464,464,0
2023,1,منطقة تبوك,الصناعة,صغيرة,1,3,3,0,8,8,0
2023,1,منطقة تبوك,الصناعة,متناهية الصغر,1,1,0,1,0,0,0
2023,1,منطقة جازان,الصناعة,كبيرة,1,236,228,8,63,59,4
2023,1,منطقة جازان,الصناعة,متناهية الصغر,2,1,1,0,3,3,0
2023,1,منطقة حائل,الصناعة,متناهية الصغر,1,0,0,0,3,3,0
2023,1,منطقة عسير,الصناعة,صغيرة,1,6,3,3,19,19,0
2023,1,منطقة عسير,الصناعة,متوسطة,1,16,9,7,46,46,0
2023,1,منطقة مكة المكرمة,الصناعة,صغيرة,19,100,58,42,259,257,2
2023,1,منطقة مكة المكرمة,الصناعة,كبيرة,4,3156,3055,101,1479,1464,15
2023,1,منطقة مكة المكرمة,الصناعة,متناهية الصغر,18,13,9,4,30,29,1
2023,1,منطقة مكة المكرمة,الصناعة,متوسطة,5,146,127,19,176,175,1
2023,1,المنطقة الشرقية,الصناعة,صغيرة,51,297,154,143,941,938,3
2023,1,المنطقة الشرقية,الصناعة,كبيرة,7,723,559,164,1726,1722,4
2023,1,المنطقة الشرقية,الصناعة,متناهية الصغر,46,27,10,17,98,97,1
2023,1,المنطقة الشرقية,الصناعة,متوسطة,23,742,483,259,1827,1821,6
2023,1,منطقة الجوف,الصناعة,صغيرة,1,2,2,0,9,9,0
2023,1,منطقة الجوف,الصناعة,متناهية الصغر,2,0,0,0,6,6,0
2023,1,منطقة الحدود الشمالية,الصناعة,صغيرة,2,3,1,2,25,25,0
2023,1,منطقة الحدود الشمالية,الصناعة,متناهية الصغر,1,0,0,0,1,1,0
2023,1,منطقة الرياض,الصناعة,صغيرة,113,576,230,346,1757,1743,14
2023,1,منطقة الرياض,الصناعة,كبيرة,2,146,33,113,383,383,0
2023,1,منطقة الرياض,الصناعة,متناهية الصغر,119,52,24,28,271,268,3
2023,1,منطقة الرياض,الصناعة,متوسطة,44,1161,661,500,3518,3504,14
2023,1,منطقة القصيم,الصناعة,صغيرة,12,46,21,25,175,174,1
2023,1,منطقة القصيم,الصناعة,متناهية الصغر,18,5,1,4,42,42,0
2023,1,منطقة القصيم,الصناعة,متوسطة,4,102,61,41,344,344,0
2023,1,منطقة المدينة المنورة,الصناعة,صغيرة,13,55,28,27,202,197,5
2023,1,منطقة المدينة المنورة,الصناعة,متناهية الصغر,15,6,1,5,21,21,0
2023,1,منطقة المدينة المنورة,الصناعة,متوسطة,2,32,26,6,108,108,0
2023,1,منطقة تبوك,الصناعة,صغيرة,4,16,9,7,72,72,0
2023,1,منطقة تبوك,الصناعة,متناهية الصغر,3,0,0,0,7,7,0
2023,1,منطقة تبوك,الصناعة,متوسطة,1,19,7,12,40,40,0
2023,1,منطقة جازان,الصناعة,صغيرة,3,8,3,5,20,20,0
2023,1,منطقة جازان,الصناعة,متناهية الصغر,4,1,0,1,11,11,0
2023,1,منطقة جازان,الصناعة,متوسطة,1,26,10,16,84,84,0
2023,1,منطقة حائل,الصناعة,صغيرة,4,20,5,15,52,52,0
2023,1,منطقة حائل,الصناعة,متناهية الصغر,5,1,1,0,19,19,0
2023,1,منطقة عسير,الصناعة,صغيرة,10,32,15,17,104,104,0
2023,1,منطقة عسير,الصناعة,متناهية الصغر,10,5,3,2,27,27,0
2023,1,منطقة عسير,الصناعة,متوسطة,1,16,3,13,49,49,0
2023,1,منطقة مكة المكرمة,الصناعة,صغيرة,82,340,199,141,1140,1135,5
2023,1,منطقة مكة المكرمة,الصناعة,كبيرة,4,602,453,149,1412,1402,10
2023,1,منطقة مكة المكرمة,الصناعة,متناهية الصغر,58,29,14,15,123,117,6
2023,1,منطقة مكة المكرمة,الصناعة,متوسطة,32,977,506,471,2330,2318,12
2023,1,منطقة نجران,الصناعة,صغيرة,2,5,3,2,37,37,0
2023,1,منطقة نجران,الصناعة,متناهية الصغر,20,3,1,2,46,46,0
2023,1,المنطقة الشرقية,الصناعة,صغيرة,190,1169,784,385,3018,3001,17
2023,1,المنطقة الشرقية,الصناعة,كبيرة,19,10830,10565,265,3388,3388,0
2023,1,المنطقة الشرقية,الصناعة,متناهية الصغر,134,68,45,23,259,258,1
2023,1,المنطقة الشرقية,الصناعة,متوسطة,96,3579,3031,548,6260,6253,7
2023,1,منطقة الباحة,الصناعة,صغيرة,4,7,6,1,28,28,0
2023,1,منطقة الباحة,الصناعة,متناهية الصغر,4,0,0,0,11,11,0
2023,1,منطقة الباحة,الصناعة,متوسطة,1,19,5,14,50,50,0
2023,1,منطقة الجوف,الصناعة,صغيرة,2,3,0,3,10,10,0
2023,1,منطقة الجوف,الصناعة,متناهية الصغر,8,1,1,0,15,15,0
2023,1,منطقة الحدود الشمالية,الصناعة,صغيرة,2,13,13,0,7,7,0
2023,1,منطقة الحدود الشمالية,الصناعة,كبيرة,1,547,530,17,147,146,1
2023,1,منطقة الحدود الشمالية,الصناعة,متناهية الصغر,7,2,2,0,11,11,0
2023,1,منطقة الرياض,الصناعة,صغيرة,423,1953,844,1109,6623,6584,39
2023,1,منطقة الرياض,الصناعة,كبيرة,16,3988,2755,1233,4543,4526,17
2023,1,منطقة الرياض,الصناعة,متناهية الصغر,486,194,98,96,1008,991,17
2023,1,منطقة الرياض,الصناعة,متوسطة,108,2737,1397,1340,7530,7516,14
2023,1,منطقة القصيم,الصناعة,صغيرة,21,70,41,29,296,295,1
2023,1,منطقة القصيم,الصناعة,كبيرة,2,448,416,32,1359,1358,1
2023,1,منطقة القصيم,الصناعة,متناهية الصغر,27,13,7,6,53,53,0
2023,1,منطقة القصيم,الصناعة,متوسطة,7,189,116,73,564,564,0
2023,1,منطقة المدينة المنورة,الصناعة,صغيرة,34,184,139,45,446,444,2
2023,1,منطقة المدينة المنورة,الصناعة,كبيرة,5,2785,2764,21,655,655,0
2023,1,منطقة المدينة المنورة,الصناعة,متناهية الصغر,35,16,5,11,63,61,2
2023,1,منطقة المدينة المنورة,الصناعة,متوسطة,15,487,425,62,793,792,1
2023,1,منطقة تبوك,الصناعة,صغيرة,11,60,38,22,198,196,2
2023,1,منطقة تبوك,الصناعة,كبيرة,1,372,218,154,513,512,1
2023,1,منطقة تبوك,الصناعة,متناهية الصغر,18,5,3,2,42,42,0
2023,1,منطقة جازان,الصناعة,صغيرة,10,26,9,17,100,99,1
2023,1,منطقة جازان,الصناعة,متناهية الصغر,18,7,3,4,48,46,2
2023,1,منطقة جازان,الصناعة,متوسطة,1,9,9,0,66,66,0
2023,1,منطقة حائل,الصناعة,صغيرة,11,14,6,8,121,121,0
2023,1,منطقة حائل,الصناعة,متناهية الصغر,55,8,5,3,152,152,0
2023,1,منطقة حائل,الصناعة,متوسطة,1,6,5,1,44,44,0
2023,1,منطقة عسير,الصناعة,صغيرة,25,97,52,45,415,413,2
2023,1,منطقة عسير,الصناعة,كبيرة,1,613,491,122,1405,1401,4
2023,1,منطقة عسير,الصناعة,متناهية الصغر,32,12,8,4,68,68,0
2023,1,منطقة عسير,الصناعة,متوسطة,5,130,84,46,341,341,0
2023,1,منطقة مكة المكرمة,الصناعة,صغيرة,206,1008,518,490,3272,3239,33
2023,1,منطقة مكة المكرمة,الصناعة,كبيرة,4,719,533,186,1467,1463,4
2023,1,منطقة مكة المكرمة,الصناعة,متناهية الصغر,250,126,70,56,512,497,15
2023,1,منطقة مكة المكرمة,الصناعة,متوسطة,77,2207,1320,887,5379,5345,34
2023,1,منطقة نجران,الصناعة,صغيرة,5,18,15,3,101,101,0
2023,1,منطقة نجران,الصناعة,متناهية الصغر,10,1,1,0,21,21,0
2023,1,منطقة نجران,الصناعة,متوسطة,3,61,23,38,160,160,0
2023,1,المنطقة الشرقية,الصناعة,صغيرة,78,176,85,91,819,806,13
2023,1,المنطقة الشرقية,الصناعة,كبيرة,1,69,47,22,183,183,0
2023,1,المنطقة الشرقية,الصناعة,متناهية الصغر,305,60,29,31,675,661,14
2023,1,المنطقة الشرقية,الصناعة,متوسطة,7,164,139,25,636,635,1
2023,1,منطقة الباحة,الصناعة,صغيرة,2,5,3,2,24,24,0
2023,1,منطقة الباحة,الصناعة,متناهية الصغر,21,5,1,4,55,54,1
2023,1,منطقة الجوف,الصناعة,صغيرة,4,3,1,2,25,25,0
2023,1,منطقة الجوف,الصناعة,متناهية الصغر,64,9,5,4,155,154,1
2023,1,منطقة الحدود الشمالية,الصناعة,صغيرة,2,1,1,0,14,14,0
2023,1,منطقة الحدود الشمالية,الصناعة,متناهية الصغر,27,6,5,1,62,62,0
2023,1,منطقة الرياض,الصناعة,صغيرة,108,253,96,157,1186,1181,5
2023,1,منطقة الرياض,الصناعة,كبيرة,7,1507,1032,475,3850,3822,28
2023,1,منطقة الرياض,الصناعة,متناهية الصغر,554,94,33,61,1286,1276,10
2023,1,منطقة الرياض,الصناعة,متوسطة,12,312,171,141,974,971,3
2023,1,منطقة القصيم,الصناعة,صغيرة,14,29,27,2,112,112,0
2023,1,منطقة القصيم,الصناعة,متناهية الصغر,86,18,8,10,211,211,0
2023,1,منطقة القصيم,الصناعة,متوسطة,2,38,24,14,86,86,0
2023,1,منطقة المدينة المنورة,الصناعة,صغيرة,20,42,33,9,188,188,0
2023,1,منطقة المدينة المنورة,الصناعة,متناهية الصغر,144,22,7,15,315,306,9
2023,1,منطقة المدينة المنورة,الصناعة,متوسطة,5,114,69,45,358,357,1
2023,1,منطقة تبوك,الصناعة,صغيرة,6,4,0,4,37,37,0
2023,1,منطقة تبوك,الصناعة,متناهية الصغر,72,10,6,4,167,165,2
2023,1,منطقة جازان,الصناعة,صغيرة,1,3,2,1,7,7,0
2023,1,منطقة جازان,الصناعة,متناهية الصغر,32,4,2,2,69,69,0
2023,1,منطقة حائل,الصناعة,صغيرة,7,13,7,6,67,67,0
2023,1,منطقة حائل,الصناعة,متناهية الصغر,49,4,0,4,120,120,0
2023,1,منطقة عسير,الصناعة,صغيرة,6,6,4,2,45,45,0
2023,1,منطقة عسير,الصناعة,متناهية الصغر,70,13,8,5,158,155,3
2023,1,منطقة مكة المكرمة,الصناعة,صغيرة,56,152,48,104,700,696,4
2023,1,منطقة مكة المكرمة,الصناعة,كبيرة,2,214,206,8,663,663,0
2023,1,منطقة مكة المكرمة,الصناعة,متناهية الصغر,282,56,31,25,629,616,13
2023,1,منطقة مكة المكرمة,الصناعة,متوسطة,9,258,170,88,763,762,1
2023,1,منطقة نجران,الصناعة,صغيرة,3,2,0,2,27,22,5
2023,1,منطقة نجران,الصناعة,متناهية الصغر,51,6,3,3,123,120,3
2023,1,المنطقة الشرقية,الصناعة,صغيرة,335,1187,558,629,4514,4497,17
2023,1,المنطقة الشرقية,الصناعة,كبيرة,15,1606,854,752,5039,5031,8
2023,1,المنطقة الشرقية,الصناعة,متناهية الصغر,736,257,124,133,1551,1546,5
2023,1,المنطقة الشرقية,الصناعة,متوسطة,84,1986,1111,875,5973,5947,26
2023,1,منطقة الباحة,الصناعة,صغيرة,20,36,20,16,175,174,1
2023,1,منطقة الباحة,الصناعة,متناهية الصغر,98,15,10,5,196,196,0
2023,1,منطقة الباحة,الصناعة,متوسطة,1,9,4,5,53,53,0
2023,1,منطقة الجوف,الصناعة,صغيرة,39,78,43,35,348,347,1
2023,1,منطقة الجوف,الصناعة,متناهية الصغر,173,29,21,8,357,357,0
2023,1,منطقة الجوف,الصناعة,متوسطة,2,62,53,9,111,111,0
2023,1,منطقة الحدود الشمالية,الصناعة,صغيرة,18,30,15,15,189,189,0
2023,1,منطقة الحدود الشمالية,الصناعة,متناهية الصغر,108,14,10,4,244,244,0
2023,1,منطقة الحدود الشمالية,الصناعة,متوسطة,1,3,2,1,57,57,0
2023,1,منطقة الرياض,الصناعة,صغيرة,601,1993,789,1204,8316,8224,92
2023,1,منطقة الرياض,الصناعة,كبيرة,51,8110,5762,2348,25787,25699,88
2023,1,منطقة الرياض,الصناعة,متناهية الصغر,1898,500,196,304,3956,3919,37
2023,1,منطقة الرياض,الصناعة,متوسطة,174,4066,1917,2149,13587,13517,70
2023,1,منطقة القصيم,الصناعة,صغيرة,115,475,258,217,1656,1649,7
2023,1,منطقة القصيم,الصناعة,كبيرة,11,958,651,307,3667,3562,105
2023,1,منطقة القصيم,الصناعة,متناهية الصغر,421,87,56,31,906,903,3
2023,1,منطقة القصيم,الصناعة,متوسطة,60,1495,872,623,4840,4834,6
2023,1,منطقة المدينة المنورة,الصناعة,صغيرة,133,442,225,217,1735,1724,11
2023,1,منطقة المدينة المنورة,الصناعة,كبيرة,1,116,83,33,319,319,0
2023,1,منطقة المدينة المنورة,الصناعة,متناهية الصغر,522,129,74,55,1105,1090,15
2023,1,منطقة المدينة المنورة,الصناعة,متوسطة,15,567,401,166,1422,1421,1
2023,1,منطقة تبوك,الصناعة,صغيرة,33,89,55,34,427,427,0
2023,1,منطقة تبوك,الصناعة,كبيرة,2,199,42,157,622,621,1
2023,1,منطقة تبوك,الصناعة,متناهية الصغر,217,48,18,30,424,424,0
2023,1,منطقة تبوك,الصناعة,متوسطة,8,144,44,100,585,585,0
2023,1,منطقة جازان,الصناعة,صغيرة,57,157,76,81,687,681,6
2023,1,منطقة جازان,الصناعة,متناهية الصغر,301,56,35,21,653,649,4
2023,1,منطقة جازان,الصناعة,متوسطة,6,184,100,84,557,556,1
2023,1,منطقة حائل,الصناعة,صغيرة,32,95,37,58,389,388,1
2023,1,منطقة حائل,الصناعة,كبيرة,1,82,36,46,200,199,1
2023,1,منطقة حائل,الصناعة,متناهية الصغر,214,44,23,21,466,464,2
2023,1,منطقة حائل,الصناعة,متوسطة,10,258,78,180,788,783,5
2023,1,منطقة عسير,الصناعة,صغيرة,91,272,120,152,1218,1217,1
2023,1,منطقة عسير,الصناعة,كبيرة,4,317,175,142,1670,1670,0
2023,1,منطقة عسير,الصناعة,متناهية الصغر,532,116,59,57,1051,1050,1
2023,1,منطقة عسير,الصناعة,متوسطة,15,400,216,184,1068,1068,0
2023,1,منطقة مكة المكرمة,الصناعة,صغيرة,439,1470,701,769,5474,5421,53
2023,1,منطقة مكة المكرمة,الصناعة,كبيرة,35,6410,3373,3037,16859,16496,363
2023,1,منطقة مكة المكرمة,الصناعة,متناهية الصغر,1492,376,183,193,3243,3215,28
2023,1,منطقة مكة المكرمة,الصناعة,متوسطة,110,2809,1340,1469,8760,8706,54
2023,1,منطقة نجران,الصناعة,صغيرة,18,41,15,26,207,207,0
2023,1,منطقة نجران,الصناعة,متناهية الصغر,179,28,14,14,394,391,3
2023,1,المنطقة الشرقية,الصناعة,صغيرة,8,36,18,18,98,81,17
2023,1,المنطقة الشرقية,الصناعة,كبيرة,1,180,115,65,387,383,4
2023,1,المنطقة الشرقية,الصناعة,متناهية الصغر,12,6,2,4,26,24,2
2023,1,المنطقة الشرقية,الصناعة,متوسطة,5,218,158,60,298,292,6
2023,1,منطقة الباحة,الصناعة,متناهية الصغر,1,0,0,0,2,2,0
2023,1,منطقة الجوف,الصناعة,متناهية الصغر,6,0,0,0,16,16,0
2023,1,منطقة الحدود الشمالية,الصناعة,متناهية الصغر,3,3,1,2,5,5,0
2023,1,منطقة الرياض,الصناعة,صغيرة,32,192,84,108,388,381,7
2023,1,منطقة الرياض,الصناعة,كبيرة,5,582,296,286,1485,1457,28
2023,1,منطقة الرياض,الصناعة,متناهية الصغر,257,50,19,31,703,698,5
2023,1,منطقة الرياض,الصناعة,متوسطة,11,315,122,193,691,679,12
2023,1,منطقة القصيم,الصناعة,صغيرة,1,1,1,0,14,14,0
2023,1,منطقة القصيم,الصناعة,كبيرة,1,337,310,27,353,353,0
2023,1,منطقة القصيم,الصناعة,متناهية الصغر,11,1,0,1,28,28,0
2023,1,منطقة القصيم,الصناعة,متوسطة,1,30,25,5,83,75,8
2023,1,منطقة المدينة المنورة,الصناعة,صغيرة,1,9,8,1,28,28,0
2023,1,منطقة المدينة المنورة,الصناعة,متناهية الصغر,6,1,0,1,9,9,0
2023,1,منطقة تبوك,الصناعة,متناهية الصغر,3,0,0,0,8,8,0
2023,1,منطقة جازان,الصناعة,متناهية الصغر,5,0,0,0,11,9,2
2023,1,منطقة حائل,الصناعة,صغيرة,1,2,0,2,5,5,0
2023,1,منطقة حائل,الصناعة,متناهية الصغر,7,1,1,0,18,18,0
2023,1,منطقة حائل,الصناعة,متوسطة,1,88,61,27,64,63,1
2023,1,منطقة عسير,الصناعة,متناهية الصغر,7,3,3,0,20,20,0
2023,1,منطقة عسير,الصناعة,متوسطة,1,17,4,13,37,30,7
2023,1,منطقة مكة المكرمة,الصناعة,صغيرة,16,105,67,38,141,135,6
2023,1,منطقة مكة المكرمة,الصناعة,كبيرة,2,611,317,294,671,652,19
2023,1,منطقة مكة المكرمة,الصناعة,متناهية الصغر,33,19,10,9,53,52,1
2023,1,منطقة مكة المكرمة,الصناعة,متوسطة,7,322,175,147,503,481,22
2023,1,منطقة نجران,الصناعة,صغيرة,1,2,0,2,21,21,0
2023,1,منطقة نجران,الصناعة,متناهية الصغر,3,0,0,0,8,8,0
2023,1,المنطقة الشرقية,الصناعة,صغيرة,8,14,7,7,151,151,0
2023,1,المنطقة الشرقية,الصناعة,متناهية الصغر,15,3,2,1,32,32,0
2023,1,المنطقة الشرقية,الصناعة,متوسطة,1,50,50,0,90,90,0
2023,1,منطقة الجوف,الصناعة,متناهية الصغر,2,1,1,0,6,6,0
2023,1,منطقة الحدود الشمالية,الصناعة,صغيرة,1,0,0,0,8,8,0
2023,1,منطقة الحدود الشمالية,الصناعة,متناهية الصغر,7,1,0,1,16,16,0
2023,1,منطقة الرياض,الصناعة,صغيرة,38,44,21,23,408,405,3
2023,1,منطقة الرياض,الصناعة,كبيرة,2,154,34,120,622,620,2
2023,1,منطقة الرياض,الصناعة,متناهية الصغر,77,9,6,3,203,203,0
2023,1,منطقة الرياض,الصناعة,متوسطة,6,167,52,115,682,679,3
2023,1,منطقة القصيم,الصناعة,صغيرة,1,1,0,1,8,8,0
2023,1,منطقة القصيم,الصناعة,متناهية الصغر,7,1,0,1,15,15,0
2023,1,منطقة المدينة المنورة,الصناعة,صغيرة,2,1,0,1,17,17,0
2023,1,منطقة المدينة المنورة,الصناعة,متناهية الصغر,9,2,1,1,23,22,1
2023,1,منطقة المدينة المنورة,الصناعة,متوسطة,1,11,4,7,48,48,0
2023,1,منطقة تبوك,الصناعة,متناهية الصغر,1,0,0,0,1,1,0
2023,1,منطقة جازان,الصناعة,متناهية الصغر,53,2,1,1,176,176,0
2023,1,منطقة حائل,الصناعة,صغيرة,2,0,0,0,12,12,0
2023,1,منطقة حائل,الصناعة,متناهية الصغر,7,0,0,0,20,20,0
2023,1,منطقة عسير,الصناعة,صغيرة,1,0,0,0,7,7,0
2023,1,منطقة عسير,الصناعة,متناهية الصغر,9,2,2,0,22,22,0
2023,1,منطقة مكة المكرمة,الصناعة,صغيرة,8,36,13,23,145,144,1
2023,1,منطقة مكة المكرمة,الصناعة,متناهية الصغر,30,4,2,2,76,76,0
2023,1,منطقة مكة المكرمة,الصناعة,متوسطة,1,13,7,6,39,39,0
2023,1,منطقة نجران,الصناعة,متناهية الصغر,3,0,0,0,5,5,0
2023,1,المنطقة الشرقية,الصناعة,صغيرة,239,554,210,344,2247,1999,248
2023,1,المنطقة الشرقية,الصناعة,متناهية الصغر,2304,328,124,204,4978,4690,288
2023,1,المنطقة الشرقية,الصناعة,متوسطة,13,394,83,311,977,971,6
2023,1,منطقة الباحة,الصناعة,صغيرة,13,17,7,10,113,91,22
2023,1,منطقة الباحة,الصناعة,متناهية الصغر,156,27,13,14,287,255,32
2023,1,منطقة الجوف,الصناعة,صغيرة,13,12,6,6,85,68,17
2023,1,منطقة الجوف,الصناعة,متناهية الصغر,296,24,11,13,621,584,37
2023,1,منطقة الحدود الشمالية,الصناعة,صغيرة,4,9,4,5,25,14,11
2023,1,منطقة الحدود الشمالية,الصناعة,متناهية الصغر,286,17,8,9,709,674,35
2023,1,منطقة الرياض,الصناعة,صغيرة,437,1085,332,753,4278,3855,423
2023,1,منطقة الرياض,الصناعة,كبيرة,5,533,110,423,1836,1808,28
2023,1,منطقة الرياض,الصناعة,متناهية الصغر,3865,613,210,403,8307,7665,642
2023,1,منطقة الرياض,الصناعة,متوسطة,34,863,271,592,2446,2253,193
2023,1,منطقة القصيم,الصناعة,صغيرة,36,66,28,38,270,226,44
2023,1,منطقة القصيم,الصناعة,متناهية الصغر,828,85,43,42,1716,1602,114
2023,1,منطقة القصيم,الصناعة,متوسطة,4,97,67,30,291,290,1
2023,1,منطقة المدينة المنورة,الصناعة,صغيرة,50,69,29,40,381,320,61
2023,1,منطقة المدينة المنورة,الصناعة,متناهية الصغر,1084,142,60,82,2303,2053,250
2023,1,منطقة المدينة المنورة,الصناعة,متوسطة,4,118,47,71,334,326,8
2023,1,منطقة تبوك,الصناعة,صغيرة,20,37,15,22,195,184,11
2023,1,منطقة تبوك,الصناعة,متناهية الصغر,812,60,24,36,2133,2096,37
2023,1,منطقة تبوك,الصناعة,متوسطة,1,0,0,0,89,89,0
2023,1,منطقة جازان,الصناعة,صغيرة,23,56,19,37,158,143,15
2023,1,منطقة جازان,الصناعة,متناهية الصغر,657,60,26,34,1403,1292,111
2023,1,منطقة حائل,الصناعة,صغيرة,24,38,9,29,235,226,9
2023,1,منطقة حائل,الصناعة,كبيرة,1,43,8,35,300,300,0
2023,1,منطقة حائل,الصناعة,متناهية الصغر,416,40,14,26,874,794,80
2023,1,منطقة عسير,الصناعة,صغيرة,51,91,40,51,429,404,25
2023,1,منطقة عسير,الصناعة,متناهية الصغر,1052,126,55,71,2223,2029,194
2023,1,منطقة عسير,الصناعة,متوسطة,3,46,23,23,183,183,0
2023,1,منطقة مكة المكرمة,الصناعة,صغيرة,198,507,150,357,1868,1652,216
2023,1,منطقة مكة المكرمة,الصناعة,كبيرة,2,231,55,176,606,606,0
2023,1,منطقة مكة المكرمة,الصناعة,متناهية الصغر,2980,419,166,253,6309,5745,564
2023,1,منطقة مكة المكرمة,الصناعة,متوسطة,21,445,115,330,1244,1239,5
2023,1,منطقة نجران,الصناعة,صغيرة,20,32,9,23,160,155,5
2023,1,منطقة نجران,الصناعة,متناهية الصغر,417,27,9,18,932,867,65
2023,1,منطقة نجران,الصناعة,متوسطة,1,22,5,17,47,47,0
2023,1,المنطقة الشرقية,الصناعة,صغيرة,58,335,233,102,955,949,6
2023,1,المنطقة الشرقية,الصناعة,كبيرة,9,2210,2090,120,1937,1931,6
2023,1,المنطقة الشرقية,الصناعة,متناهية الصغر,117,44,27,17,249,249,0
2023,1,المنطقة الشرقية,الصناعة,متوسطة,27,830,628,202,1744,1742,2
2023,1,منطقة الباحة,الصناعة,متناهية الصغر,5,0,0,0,9,9,0
2023,1,منطقة الجوف,الصناعة,صغيرة,1,1,1,0,5,5,0
2023,1,منطقة الجوف,الصناعة,متناهية الصغر,13,1,1,0,18,18,0
2023,1,منطقة الحدود الشمالية,الصناعة,متناهية الصغر,16,0,0,0,34,34,0
2023,1,منطقة الرياض,الصناعة,صغيرة,91,393,191,202,1542,1534,8
2023,1,منطقة الرياض,الصناعة,كبيرة,12,1179,937,242,2988,2983,5
2023,1,منطقة الرياض,الصناعة,متناهية الصغر,163,54,29,25,352,352,0
2023,1,منطقة الرياض,الصناعة,متوسطة,51,1482,911,571,3988,3977,11
2023,1,منطقة القصيم,الصناعة,صغيرة,15,34,17,17,194,193,1
2023,1,منطقة القصيم,الصناعة,متناهية الصغر,24,3,3,0,47,47,0
2023,1,منطقة القصيم,الصناعة,متوسطة,2,24,13,11,128,128,0
2023,1,منطقة المدينة المنورة,الصناعة,صغيرة,11,52,36,16,155,153,2
2023,1,منطقة المدينة المنورة,الصناعة,كبيرة,1,112,103,9,300,300,0
2023,1,منطقة المدينة المنورة,الصناعة,متناهية الصغر,40,5,4,1,75,75,0
2023,1,منطقة المدينة المنورة,الصناعة,متوسطة,2,71,39,32,244,244,0
2023,1,منطقة تبوك,الصناعة,صغيرة,1,3,0,3,7,7,0
2023,1,منطقة تبوك,الصناعة,متناهية الصغر,8,0,0,0,16,16,0
2023,1,منطقة جازان,الصناعة,متناهية الصغر,28,1,1,0,77,77,0
2023,1,منطقة حائل,الصناعة,صغيرة,2,6,4,2,11,11,0
2023,1,منطقة حائل,الصناعة,متناهية الصغر,12,3,1,2,37,37,0
2023,1,منطقة حائل,الصناعة,متوسطة,1,37,13,24,91,91,0
2023,1,منطقة عسير,الصناعة,صغيرة,5,8,6,2,32,32,0
2023,1,منطقة عسير,الصناعة,متناهية الصغر,27,5,3,2,55,55,0
2023,1,منطقة عسير,الصناعة,متوسطة,2,29,11,18,87,87,0
2023,1,منطقة مكة المكرمة,الصناعة,صغيرة,45,195,108,87,744,742,2
2023,1,منطقة مكة المكرمة,الصناعة,كبيرة,2,292,269,23,837,836,1
2023,1,منطقة مكة المكرمة,الصناعة,متناهية الصغر,136,29,21,8,269,263,6
2023,1,منطقة مكة المكرمة,الصناعة,متوسطة,10,247,163,84,804,801,3
2023,1,منطقة نجران,الصناعة,صغيرة,2,5,3,2,30,30,0
2023,1,منطقة نجران,الصناعة,متناهية الصغر,7,2,0,2,15,15,0
2023,1,المنطقة الشرقية,الصناعة,صغيرة,23,81,43,38,359,358,1
2023,1,المنطقة الشرقية,الصناعة,كبيرة,4,577,379,198,1501,1500,1
2023,1,المنطقة الشرقية,الصناعة,متناهية الصغر,35,9,5,4,64,63,1
2023,1,المنطقة الشرقية,الصناعة,متوسطة,6,160,65,95,488,485,3
2023,1,منطقة الباحة,الصناعة,صغيرة,3,12,9,3,57,57,0
2023,1,منطقة الباحة,الصناعة,متناهية الصغر,3,1,0,1,6,6,0
2023,1,منطقة الباحة,الصناعة,متوسطة,2,70,11,59,180,180,0
2023,1,منطقة الجوف,الصناعة,صغيرة,3,5,2,3,17,17,0
2023,1,منطقة الجوف,الصناعة,متناهية الصغر,5,1,1,0,9,9,0
2023,1,منطقة الجوف,الصناعة,متوسطة,1,16,9,7,50,50,0
2023,1,منطقة الحدود الشمالية,الصناعة,صغيرة,1,3,2,1,12,12,0
2023,1,منطقة الرياض,الصناعة,صغيرة,37,172,84,88,572,572,0
2023,1,منطقة الرياض,الصناعة,كبيرة,12,1974,1324,650,4667,4659,8
2023,1,منطقة الرياض,الصناعة,متناهية الصغر,77,26,12,14,160,160,0
2023,1,منطقة الرياض,الصناعة,متوسطة,33,938,366,572,2685,2680,5
2023,1,منطقة القصيم,الصناعة,صغيرة,9,35,15,20,135,135,0
2023,1,منطقة القصيم,الصناعة,كبيرة,2,384,176,208,779,779,0
2023,1,منطقة القصيم,الصناعة,متناهية الصغر,13,2,1,1,22,22,0
2023,1,منطقة القصيم,الصناعة,متوسطة,4,155,46,109,437,437,0
2023,1,منطقة المدينة المنورة,الصناعة,صغيرة,13,69,38,31,233,232,1
2023,1,منطقة المدينة المنورة,الصناعة,متناهية الصغر,15,4,2,2,27,27,0
2023,1,منطقة المدينة المنورة,الصناعة,متوسطة,6,196,77,119,556,555,1
2023,1,منطقة تبوك,الصناعة,صغيرة,4,20,12,8,74,74,0
2023,1,منطقة تبوك,الصناعة,متناهية الصغر,15,4,4,0,38,38,0
2023,1,منطقة تبوك,الصناعة,متوسطة,2,75,41,34,151,151,0
2023,1,منطقة جازان,الصناعة,صغيرة,8,21,8,13,89,89,0
2023,1,منطقة جازان,الصناعة,كبيرة,1,61,45,16,196,196,0
2023,1,منطقة جازان,الصناعة,متناهية الصغر,21,4,3,1,50,50,0
2023,1,منطقة جازان,الصناعة,متوسطة,5,188,113,75,575,575,0
2023,1,منطقة حائل,الصناعة,صغيرة,5,21,14,7,66,66,0
2023,1,منطقة حائل,الصناعة,كبيرة,1,131,50,81,261,259,2
2023,1,منطقة حائل,الصناعة,متناهية الصغر,6,2,2,0,8,8,0
2023,1,منطقة حائل,الصناعة,متوسطة,1,16,8,8,44,43,1
2023,1,منطقة عسير,الصناعة,صغيرة,12,37,29,8,198,198,0
2023,1,منطقة عسير,الصناعة,كبيرة,1,141,122,19,310,310,0
2023,1,منطقة عسير,الصناعة,متناهية الصغر,21,3,1,2,48,48,0
2023,1,منطقة عسير,الصناعة,متوسطة,2,57,34,23,125,125,0
2023,1,منطقة مكة المكرمة,الصناعة,صغيرة,41,190,87,103,651,648,3
2023,1,منطقة مكة المكرمة,الصناعة,كبيرة,7,1258,924,334,2511,2505,6
2023,1,منطقة مكة المكرمة,الصناعة,متناهية الصغر,98,29,18,11,188,187,1
2023,1,منطقة مكة المكرمة,الصناعة,متوسطة,25,645,347,298,1917,1913,4
2023,1,منطقة نجران,الصناعة,صغيرة,2,17,5,12,67,67,0
2023,1,منطقة نجران,الصناعة,متناهية الصغر,5,0,0,0,11,11,0
2023,1,منطقة نجران,الصناعة,متوسطة,2,115,95,20,250,250,0
2023,1,المنطقة الشرقية,الصناعة,صغيرة,96,474,306,168,1509,1508,1
2023,1,المنطقة الشرقية,الصناعة,كبيرة,20,2875,2616,259,5160,5158,2
2023,1,المنطقة الشرقية,الصناعة,متناهية الصغر,108,50,40,10,200,200,0
2023,1,المنطقة الشرقية,الصناعة,متوسطة,61,2036,1428,608,4860,4859,1
2023,1,منطقة الباحة,الصناعة,متناهية الصغر,10,1,1,0,18,18,0
2023,1,منطقة الجوف,الصناعة,صغيرة,2,0,0,0,12,12,0
2023,1,منطقة الجوف,الصناعة,متناهية الصغر,15,4,4,0,36,36,0
2023,1,منطقة الحدود الشمالية,الصناعة,متناهية الصغر,10,3,3,0,23,23,0
2023,1,منطقة الرياض,الصناعة,صغيرة,180,698,334,364,2563,2547,16
2023,1,منطقة الرياض,الصناعة,كبيرة,11,1092,711,381,2931,2925,6
2023,1,منطقة الرياض,الصناعة,متناهية الصغر,337,74,37,37,754,752,2
2023,1,منطقة الرياض,الصناعة,متوسطة,62,1559,904,655,4896,4864,32
2023,1,منطقة القصيم,الصناعة,صغيرة,13,30,22,8,234,233,1
2023,1,منطقة القصيم,الصناعة,متناهية الصغر,65,8,4,4,126,125,1
2023,1,منطقة القصيم,الصناعة,متوسطة,6,60,38,22,335,335,0
2023,1,منطقة المدينة المنورة,الصناعة,صغيرة,10,32,19,13,150,149,1
2023,1,منطقة المدينة المنورة,الصناعة,متناهية الصغر,49,8,3,5,116,116,0
2023,1,منطقة المدينة المنورة,الصناعة,متوسطة,3,261,213,48,321,321,0
2023,1,منطقة تبوك,الصناعة,صغيرة,5,2,1,1,38,38,0
2023,1,منطقة تبوك,الصناعة,متناهية الصغر,10,2,1,1,19,19,0
2023,1,منطقة تبوك,الصناعة,متوسطة,2,81,30,51,208,208,0
2023,1,منطقة جازان,الصناعة,صغيرة,2,8,4,4,28,28,0
2023,1,منطقة جازان,الصناعة,كبيرة,1,150,150,0,115,115,0
2023,1,منطقة جازان,الصناعة,متناهية الصغر,36,5,3,2,85,85,0
2023,1,منطقة جازان,الصناعة,متوسطة,2,102,88,14,244,244,0
2023,1,منطقة حائل,الصناعة,صغيرة,2,3,2,1,13,13,0
2023,1,منطقة حائل,الصناعة,متناهية الصغر,36,4,1,3,81,81,0
2023,1,منطقة حائل,الصناعة,متوسطة,2,23,8,15,96,96,0
2023,1,منطقة عسير,الصناعة,صغيرة,17,46,34,12,198,197,1
2023,1,منطقة عسير,الصناعة,متناهية الصغر,66,6,2,4,135,135,0
2023,1,منطقة عسير,الصناعة,متوسطة,2,56,55,1,153,153,0
2023,1,منطقة مكة المكرمة,الصناعة,صغيرة,88,372,205,167,1427,1419,8
2023,1,منطقة مكة المكرمة,الصناعة,كبيرة,12,1413,881,532,3129,3126,3
2023,1,منطقة مكة المكرمة,الصناعة,متناهية الصغر,174,71,37,34,376,373,3
2023,1,منطقة مكة المكرمة,الصناعة,متوسطة,32,997,678,319,2610,2600,10
2023,1,منطقة نجران,الصناعة,صغيرة,1,3,0,3,10,10,0
2023,1,منطقة نجران,الصناعة,كبيرة,1,221,218,3,360,360,0
2023,1,منطقة نجران,الصناعة,متناهية الصغر,38,5,2,3,69,69,0
2023,1,منطقة نجران,الصناعة,متوسطة,1,31,15,16,107,107,0
2023,1,المنطقة الشرقية,الصناعة,صغيرة,182,489,256,233,2065,2054,11
2023,1,المنطقة الشرقية,الصناعة,كبيرة,1,61,61,0,249,249,0
2023,1,المنطقة الشرقية,الصناعة,متناهية الصغر,419,166,66,100,993,990,3
2023,1,المنطقة الشرقية,الصناعة,متوسطة,15,396,236,160,1253,1250,3
2023,1,منطقة الباحة,الصناعة,صغيرة,11,21,12,9,74,74,0
2023,1,منطقة الباحة,الصناعة,متناهية الصغر,86,19,12,7,205,204,1
2023,1,منطقة الباحة,الصناعة,متوسطة,1,40,36,4,146,146,0
2023,1,منطقة الجوف,الصناعة,صغيرة,13,16,6,10,88,88,0
2023,1,منطقة الجوف,الصناعة,متناهية الصغر,86,12,7,5,178,177,1
2023,1,منطقة الحدود الشمالية,الصناعة,صغيرة,2,4,4,0,10,10,0
2023,1,منطقة الحدود الشمالية,الصناعة,متناهية الصغر,49,5,1,4,108,108,0
2023,1,منطقة الرياض,الصناعة,صغيرة,299,756,274,482,3418,3392,26
2023,1,منطقة الرياض,الصناعة,متناهية الصغر,966,276,104,172,2266,2257,9
2023,1,منطقة الرياض,الصناعة,متوسطة,34,853,286,567,2542,2467,75
2023,1,منطقة القصيم,الصناعة,صغيرة,27,74,35,39,312,312,0
2023,1,منطقة القصيم,الصناعة,كبيرة,1,67,44,23,202,202,0
2023,1,منطقة القصيم,الصناعة,متناهية الصغر,266,49,23,26,654,654,0
2023,1,منطقة القصيم,الصناعة,متوسطة,2,28,13,15,121,121,0
2023,1,منطقة المدينة المنورة,الصناعة,صغيرة,25,67,40,27,259,259,0
2023,1,منطقة المدينة المنورة,الصناعة,متناهية الصغر,161,34,21,13,391,391,0
2023,1,منطقة المدينة المنورة,الصناعة,متوسطة,2,36,20,16,91,91,0
2023,1,منطقة تبوك,الصناعة,صغيرة,13,19,9,10,80,80,0
2023,1,منطقة تبوك,الصناعة,متناهية الصغر,91,9,4,5,212,212,0
2023,1,منطقة جازان,الصناعة,صغيرة,12,13,9,4,84,83,1
2023,1,منطقة جازان,الصناعة,متناهية الصغر,210,23,11,12,518,516,2
2023,1,منطقة جازان,الصناعة,متوسطة,2,31,5,26,134,134,0
2023,1,منطقة حائل,الصناعة,صغيرة,10,17,10,7,102,102,0
2023,1,منطقة حائل,الصناعة,متناهية الصغر,56,14,6,8,127,127,0
2023,1,منطقة عسير,الصناعة,صغيرة,34,68,39,29,355,354,1
2023,1,منطقة عسير,الصناعة,متناهية الصغر,299,59,23,36,688,686,2
2023,1,منطقة عسير,الصناعة,متوسطة,1,12,5,7,43,43,0
2023,1,منطقة مكة المكرمة,الصناعة,صغيرة,129,376,154,222,1478,1472,6
2023,1,منطقة مكة المكرمة,الصناعة,كبيرة,2,181,147,34,564,564,0
2023,1,منطقة مكة المكرمة,الصناعة,متناهية الصغر,703,148,74,74,1613,1604,9
2023,1,منطقة مكة المكرمة,الصناعة,متوسطة,13,348,168,180,979,970,9
2023,1,منطقة نجران,الصناعة,صغيرة,2,4,1,3,10,10,0
2023,1,منطقة نجران,الصناعة,متناهية الصغر,86,7,3,4,202,202,0
2023,1,المنطقة الشرقية,الصناعة,صغيرة,20,120,84,36,297,297,0
2023,1,المنطقة الشرقية,الصناعة,متناهية الصغر,46,24,16,8,76,74,2
2023,1,المنطقة الشرقية,الصناعة,متوسطة,5,168,105,63,350,350,0
2023,1,منطقة الباحة,الصناعة,متناهية الصغر,7,5,5,0,8,8,0
2023,1,منطقة الجوف,الصناعة,متناهية الصغر,4,0,0,0,12,12,0
2023,1,منطقة الحدود الشمالية,الصناعة,متناهية الصغر,4,1,1,0,6,6,0
2023,1,منطقة الرياض,الصناعة,صغيرة,26,116,80,36,323,319,4
2023,1,منطقة الرياض,الصناعة,متناهية الصغر,71,35,16,19,129,129,0
2023,1,منطقة الرياض,الصناعة,متوسطة,3,63,28,35,153,152,1
2023,1,منطقة القصيم,الصناعة,متناهية الصغر,7,0,0,0,12,12,0
2023,1,منطقة المدينة المنورة,الصناعة,صغيرة,5,19,17,2,32,32,0
2023,1,منطقة المدينة المنورة,الصناعة,متناهية الصغر,13,2,1,1,26,26,0
2023,1,منطقة تبوك,الصناعة,متناهية الصغر,11,1,0,1,16,16,0
2023,1,منطقة جازان,الصناعة,صغيرة,1,0,0,0,17,17,0
2023,1,منطقة جازان,الصناعة,متناهية الصغر,19,2,2,0,33,33,0
2023,1,منطقة حائل,الصناعة,متناهية الصغر,7,0,0,0,16,16,0
2023,1,منطقة عسير,الصناعة,صغيرة,2,3,2,1,10,10,0
2023,1,منطقة عسير,الصناعة,متناهية الصغر,37,1,1,0,71,71,0
2023,1,منطقة مكة المكرمة,الصناعة,صغيرة,20,44,25,19,180,177,3
2023,1,منطقة مكة المكرمة,الصناعة,كبيرة,1,88,83,5,176,176,0
2023,1,منطقة مكة المكرمة,الصناعة,متناهية الصغر,122,54,32,22,216,216,0
2023,1,منطقة مكة المكرمة,الصناعة,متوسطة,2,65,47,18,80,77,3
2023,1,منطقة نجران,الصناعة,متناهية الصغر,5,1,0,1,14,14,0
2023,1,المنطقة الشرقية,الصناعة,صغيرة,163,525,244,281,2203,2195,8
2023,1,المنطقة الشرقية,الصناعة,كبيرة,3,128,70,58,705,702,3
2023,1,المنطقة الشرقية,الصناعة,متناهية الصغر,543,115,49,66,1329,1327,2
2023,1,المنطقة الشرقية,الصناعة,متوسطة,30,698,353,345,2121,2113,8
2023,1,منطقة الباحة,الصناعة,صغيرة,9,5,4,1,87,87,0
2023,1,منطقة الباحة,الصناعة,متناهية الصغر,94,10,6,4,242,242,0
2023,1,منطقة الجوف,الصناعة,صغيرة,7,11,8,3,55,55,0
2023,1,منطقة الجوف,الصناعة,متناهية الصغر,124,13,7,6,267,266,1
2023,1,منطقة الحدود الشمالية,الصناعة,صغيرة,4,9,7,2,34,34,0
2023,1,منطقة الحدود الشمالية,الصناعة,متناهية الصغر,94,13,8,5,241,241,0
2023,1,منطقة الرياض,الصناعة,صغيرة,440,1151,436,715,5722,5703,19
2023,1,منطقة الرياض,الصناعة,كبيرة,11,978,415,563,3346,3339,7
2023,1,منطقة الرياض,الصناعة,متناهية الصغر,1449,209,86,123,3536,3524,12
2023,1,منطقة الرياض,الصناعة,متوسطة,89,2088,807,1281,6666,6633,33
2023,1,منطقة القصيم,الصناعة,صغيرة,60,127,80,47,663,659,4
2023,1,منطقة القصيم,الصناعة,كبيرة,1,79,25,54,346,346,0
2023,1,منطقة القصيم,الصناعة,متناهية الصغر,215,28,20,8,542,541,1
2023,1,منطقة القصيم,الصناعة,متوسطة,10,145,85,60,605,605,0
2023,1,منطقة المدينة المنورة,الصناعة,صغيرة,39,51,30,21,398,395,3
2023,1,منطقة المدينة المنورة,الصناعة,متناهية الصغر,277,46,27,19,639,637,2
2023,1,منطقة المدينة المنورة,الصناعة,متوسطة,1,16,13,3,36,36,0
2023,1,منطقة تبوك,الصناعة,صغيرة,21,12,4,8,170,170,0
2023,1,منطقة تبوك,الصناعة,متناهية الصغر,222,18,10,8,593,588,5
2023,1,منطقة جازان,الصناعة,صغيرة,21,14,9,5,161,160,1
2023,1,منطقة جازان,الصناعة,متناهية الصغر,399,32,16,16,1107,1101,6
2023,1,منطقة حائل,الصناعة,صغيرة,20,42,26,16,226,225,1
2023,1,منطقة حائل,الصناعة,متناهية الصغر,153,15,9,6,362,362,0
2023,1,منطقة عسير,الصناعة,صغيرة,67,128,69,59,695,694,1
2023,1,منطقة عسير,الصناعة,متناهية الصغر,566,63,46,17,1354,1351,3
2023,1,منطقة عسير,الصناعة,متوسطة,4,68,37,31,177,177,0
2023,1,منطقة مكة المكرمة,الصناعة,صغيرة,115,222,114,108,1268,1261,7
2023,1,منطقة مكة المكرمة,الصناعة,كبيرة,1,77,51,26,270,269,1
2023,1,منطقة مكة المكرمة,الصناعة,متناهية الصغر,739,108,50,58,1765,1757,8
2023,1,منطقة مكة المكرمة,الصناعة,متوسطة,32,871,335,536,2650,2635,15
2023,1,منطقة نجران,الصناعة,صغيرة,15,33,11,22,179,179,0
2023,1,منطقة نجران,الصناعة,متناهية الصغر,109,15,6,9,284,284,0
2023,1,منطقة نجران,الصناعة,متوسطة,3,82,21,61,267,267,0
2023,1,المنطقة الشرقية,الصناعة,صغيرة,5,22,7,15,61,60,1
2023,1,المنطقة الشرقية,الصناعة,كبيرة,3,2928,2854,74,785,785,0
2023,1,المنطقة الشرقية,الصناعة,متناهية الصغر,12,5,3,2,22,22,0
2023,1,المنطقة الشرقية,الصناعة,متوسطة,3,49,42,7,161,161,0
2023,1,منطقة الباحة,الصناعة,متناهية الصغر,1,0,0,0,1,1,0
2023,1,منطقة الجوف,الصناعة,متناهية الصغر,1,0,0,0,1,1,0
2023,1,منطقة الحدود الشمالية,الصناعة,متناهية الصغر,1,0,0,0,3,3,0
2023,1,منطقة الرياض,الصناعة,صغيرة,14,97,74,23,157,155,2
2023,1,منطقة الرياض,الصناعة,كبيرة,2,1314,1261,53,767,767,0
2023,1,منطقة الرياض,الصناعة,متناهية الصغر,66,21,8,13,144,143,1
2023,1,منطقة الرياض,الصناعة,متوسطة,5,183,103,80,259,259,0
2023,1,منطقة القصيم,الصناعة,متناهية الصغر,1,0,0,0,1,1,0
2023,1,منطقة المدينة المنورة,الصناعة,صغيرة,2,1,1,0,16,16,0
2023,1,منطقة المدينة المنورة,الصناعة,متناهية الصغر,8,2,2,0,12,12,0
2023,1,منطقة تبوك,الصناعة,متناهية الصغر,1,1,0,1,1,1,0
2023,1,منطقة جازان,الصناعة,صغيرة,1,7,6,1,30,30,0
2023,1,منطقة جازان,الصناعة,متناهية الصغر,5,0,0,0,16,16,0
2023,1,منطقة حائل,الصناعة,متناهية الصغر,1,0,0,0,3,3,0
2023,1,منطقة عسير,الصناعة,متناهية الصغر,5,1,1,0,14,14,0
2023,1,منطقة مكة المكرمة,الصناعة,صغيرة,5,54,13,41,84,78,6
2023,1,منطقة مكة المكرمة,الصناعة,متناهية الصغر,28,8,5,3,59,57,2
2023,1,منطقة مكة المكرمة,الصناعة,متوسطة,3,19,13,6,161,161,0
2023,1,منطقة نجران,الصناعة,صغيرة,1,0,0,0,6,6,0
2023,1,منطقة نجران,الصناعة,متناهية الصغر,3,1,0,1,6,6,0
2023,1,المنطقة الشرقية,الصناعة,صغيرة,26,148,91,57,408,408,0
2023,1,المنطقة الشرقية,الصناعة,كبيرة,2,298,282,16,807,807,0
2023,1,المنطقة الشرقية,الصناعة,متناهية الصغر,29,8,6,2,68,68,0
2023,1,المنطقة الشرقية,الصناعة,متوسطة,10,358,270,88,1005,1004,1
2023,1,منطقة الباحة,الصناعة,متناهية الصغر,2,0,0,0,3,3,0
2023,1,منطقة الجوف,الصناعة,صغيرة,1,2,2,0,8,8,0
2023,1,منطقة الجوف,الصناعة,متناهية الصغر,9,1,1,0,18,18,0
2023,1,منطقة الحدود الشمالية,الصناعة,متناهية الصغر,1,0,0,0,2,2,0
2023,1,منطقة الرياض,الصناعة,صغيرة,35,163,94,69,626,625,1
2023,1,منطقة الرياض,الصناعة,كبيرة,2,204,68,136,944,940,4
2023,1,منطقة الرياض,الصناعة,متناهية الصغر,59,23,11,12,131,130,1
2023,1,منطقة الرياض,الصناعة,متوسطة,14,330,132,198,857,849,8
2023,1,منطقة القصيم,الصناعة,صغيرة,9,48,28,20,141,141,0
2023,1,منطقة القصيم,الصناعة,كبيرة,1,101,79,22,259,259,0
2023,1,منطقة القصيم,الصناعة,متناهية الصغر,11,1,1,0,29,29,0
2023,1,منطقة المدينة المنورة,الصناعة,صغيرة,2,1,1,0,21,21,0
2023,1,منطقة المدينة المنورة,الصناعة,متناهية الصغر,14,2,0,2,32,32,0
2023,1,منطقة تبوك,الصناعة,صغيرة,1,11,3,8,27,27,0
2023,1,منطقة تبوك,الصناعة,متناهية الصغر,5,3,2,1,19,19,0
2023,1,منطقة جازان,الصناعة,صغيرة,1,4,1,3,17,17,0
2023,1,منطقة جازان,الصناعة,متناهية الصغر,12,1,1,0,33,33,0
2023,1,منطقة حائل,الصناعة,صغيرة,1,0,0,0,6,6,0
2023,1,منطقة حائل,الصناعة,متناهية الصغر,5,1,1,0,10,10,0
2023,1,منطقة عسير,الصناعة,صغيرة,1,1,0,1,5,5,0
2023,1,منطقة عسير,الصناعة,متناهية الصغر,9,2,1,1,18,18,0
2023,1,منطقة مكة المكرمة,الصناعة,صغيرة,15,60,44,16,176,176,0
2023,1,منطقة مكة المكرمة,الصناعة,كبيرة,1,85,66,19,220,220,0
2023,1,منطقة مكة المكرمة,الصناعة,متناهية الصغر,41,10,7,3,97,97,0
2023,1,منطقة مكة المكرمة,الصناعة,متوسطة,9,415,279,136,788,788,0
2023,1,منطقة نجران,الصناعة,متناهية الصغر,8,1,0,1,13,13,0
2023,1,المنطقة الشرقية,الصناعة,صغيرة,72,526,379,147,1130,1128,2
2023,1,المنطقة الشرقية,الصناعة,كبيرة,7,1599,1467,132,2101,2099,2
2023,1,المنطقة الشرقية,الصناعة,متناهية الصغر,67,30,19,11,127,126,1
2023,1,المنطقة الشرقية,الصناعة,متوسطة,37,1519,1282,237,2365,2361,4
2023,1,منطقة الباحة,الصناعة,صغيرة,1,1,0,1,5,5,0
2023,1,منطقة الباحة,الصناعة,متناهية الصغر,6,4,3,1,9,9,0
2023,1,منطقة الجوف,الصناعة,متناهية الصغر,2,0,0,0,6,6,0
2023,1,منطقة الحدود الشمالية,الصناعة,متناهية الصغر,3,0,0,0,10,10,0
2023,1,منطقة الرياض,الصناعة,صغيرة,91,335,169,166,1436,1429,7
2023,1,منطقة الرياض,الصناعة,كبيرة,2,253,100,153,499,498,1
2023,1,منطقة الرياض,الصناعة,متناهية الصغر,274,63,36,27,616,611,5
2023,1,منطقة الرياض,الصناعة,متوسطة,31,925,505,420,2743,2738,5
2023,1,منطقة القصيم,الصناعة,صغيرة,4,8,5,3,32,32,0
2023,1,منطقة القصيم,الصناعة,متناهية الصغر,31,4,3,1,61,61,0
2023,1,منطقة القصيم,الصناعة,متوسطة,3,72,33,39,209,209,0
2023,1,منطقة المدينة المنورة,الصناعة,صغيرة,5,31,17,14,82,81,1
2023,1,منطقة المدينة المنورة,الصناعة,متناهية الصغر,19,1,0,1,52,52,0
2023,1,منطقة المدينة المنورة,الصناعة,متوسطة,4,58,34,24,237,237,0
2023,1,منطقة تبوك,الصناعة,متناهية الصغر,6,1,1,0,11,11,0
2023,1,منطقة جازان,الصناعة,صغيرة,2,2,1,1,21,21,0
2023,1,منطقة جازان,الصناعة,متناهية الصغر,18,1,0,1,46,46,0
2023,1,منطقة حائل,الصناعة,صغيرة,1,16,16,0,3,3,0
2023,1,منطقة حائل,الصناعة,متناهية الصغر,13,0,0,0,29,29,0
2023,1,منطقة عسير,الصناعة,صغيرة,4,16,13,3,58,57,1
2023,1,منطقة عسير,الصناعة,متناهية الصغر,17,2,1,1,30,30,0
2023,1,منطقة عسير,الصناعة,متوسطة,3,71,71,0,182,182,0
2023,1,منطقة مكة المكرمة,الصناعة,صغيرة,37,145,70,75,512,510,2
2023,1,منطقة مكة المكرمة,الصناعة,كبيرة,2,652,639,13,1073,1069,4
2023,1,منطقة مكة المكرمة,الصناعة,متناهية الصغر,83,23,15,8,166,165,1
2023,1,منطقة مكة المكرمة,الصناعة,متوسطة,18,536,369,167,1319,1312,7
2023,1,منطقة نجران,الصناعة,صغيرة,1,0,0,0,6,6,0
2023,1,منطقة نجران,الصناعة,متناهية الصغر,10,1,0,1,27,27,0
2023,1,منطقة نجران,الصناعة,متوسطة,1,0,0,0,90,90,0
2023,1,المنطقة الشرقية,توصيل الكهرباء والغاز والبخار وتكييف الهواء,صغيرة,53,302,221,81,622,621,1
2023,1,المنطقة الشرقية,توصيل الكهرباء والغاز والبخار وتكييف الهواء,كبيرة,1,6016,6004,12,467,467,0
2023,1,المنطقة الشرقية,توصيل الكهرباء والغاز والبخار وتكييف الهواء,متناهية الصغر,62,38,21,17,123,121,2
2023,1,المنطقة الشرقية,توصيل الكهرباء والغاز والبخار وتكييف الهواء,متوسطة,7,270,216,54,293,293,0
2023,1,منطقة الباحة,توصيل الكهرباء والغاز والبخار وتكييف الهواء,متناهية الصغر,4,3,3,0,8,8,0
2023,1,منطقة الجوف,توصيل الكهرباء والغاز والبخار وتكييف الهواء,متناهية الصغر,6,1,1,0,10,10,0
2023,1,منطقة الحدود الشمالية,توصيل الكهرباء والغاز والبخار وتكييف الهواء,متناهية الصغر,3,1,1,0,7,7,0
2023,1,منطقة الرياض,توصيل الكهرباء والغاز والبخار وتكييف الهواء,صغيرة,70,359,202,157,795,791,4
2023,1,منطقة الرياض,توصيل الكهرباء والغاز والبخار وتكييف الهواء,كبيرة,2,10490,10092,398,951,946,5
2023,1,منطقة الرياض,توصيل الكهرباء والغاز والبخار وتكييف الهواء,متناهية الصغر,112,87,46,41,215,214,1
2023,1,منطقة الرياض,توصيل الكهرباء والغاز والبخار وتكييف الهواء,متوسطة,5,316,257,59,240,240,0
2023,1,منطقة القصيم,توصيل الكهرباء والغاز والبخار وتكييف الهواء,صغيرة,2,10,7,3,37,37,0
2023,1,منطقة القصيم,توصيل الكهرباء والغاز والبخار وتكييف الهواء,متناهية الصغر,13,1,1,0,38,38,0
2023,1,منطقة القصيم,توصيل الكهرباء والغاز والبخار وتكييف الهواء,متوسطة,1,63,63,0,132,132,0
2023,1,منطقة المدينة المنورة,توصيل الكهرباء والغاز والبخار وتكييف الهواء,صغيرة,3,34,34,0,16,16,0
2023,1,منطقة المدينة المنورة,توصيل الكهرباء والغاز والبخار وتكييف الهواء,متناهية الصغر,20,8,3,5,38,38,0
2023,1,منطقة المدينة المنورة,توصيل الكهرباء والغاز والبخار وتكييف الهواء,متوسطة,1,95,95,0,2,2,0
2023,1,منطقة تبوك,توصيل الكهرباء والغاز والبخار وتكييف الهواء,متناهية الصغر,13,3,0,3,25,25,0
2023,1,منطقة جازان,توصيل الكهرباء والغاز والبخار وتكييف الهواء,صغيرة,3,23,17,6,46,46,0
2023,1,منطقة جازان,توصيل الكهرباء والغاز والبخار وتكييف الهواء,متناهية الصغر,20,4,3,1,41,41,0
2023,1,منطقة جازان,توصيل الكهرباء والغاز والبخار وتكييف الهواء,متوسطة,2,7,7,0,137,137,0
2023,1,منطقة حائل,توصيل الكهرباء والغاز والبخار وتكييف الهواء,متناهية الصغر,9,5,4,1,21,21,0
2023,1,منطقة عسير,توصيل الكهرباء والغاز والبخار وتكييف الهواء,صغيرة,5,20,9,11,57,57,0
2023,1,منطقة عسير,توصيل الكهرباء والغاز والبخار وتكييف الهواء,كبيرة,1,4531,4531,0,248,248,0
2023,1,منطقة عسير,توصيل الكهرباء والغاز والبخار وتكييف الهواء,متناهية الصغر,23,7,3,4,46,46,0
2023,1,منطقة عسير,توصيل الكهرباء والغاز والبخار وتكييف الهواء,متوسطة,3,164,159,5,150,150,0
2023,1,منطقة مكة المكرمة,توصيل الكهرباء والغاز والبخار وتكييف الهواء,صغيرة,29,179,100,79,479,479,0
2023,1,منطقة مكة المكرمة,توصيل الكهرباء والغاز والبخار وتكييف الهواء,كبيرة,2,9216,9215,1,627,627,0
2023,1,منطقة مكة المكرمة,توصيل الكهرباء والغاز والبخار وتكييف الهواء,متناهية الصغر,65,19,15,4,114,114,0
2023,1,منطقة مكة المكرمة,توصيل الكهرباء والغاز والبخار وتكييف الهواء,متوسطة,5,169,129,40,301,300,1
2023,1,منطقة نجران,توصيل الكهرباء والغاز والبخار وتكييف الهواء,صغيرة,1,1,1,0,8,8,0
2023,1,منطقة نجران,توصيل الكهرباء والغاز والبخار وتكييف الهواء,متناهية الصغر,7,0,0,0,14,14,0
2023,1,المنطقة الشرقية,تمويل التأمين وإعادة التأمين وصناديق المعاشات التقاعدية باستثناء الضمان الاجتماعي الإلزامي,صغيرة,7,117,74,43,34,31,3
2023,1,المنطقة الشرقية,تمويل التأمين وإعادة التأمين وصناديق المعاشات التقاعدية باستثناء الضمان الاجتماعي الإلزامي,كبيرة,2,582,429,153,162,152,10
2023,1,المنطقة الشرقية,تمويل التأمين وإعادة التأمين وصناديق المعاشات التقاعدية باستثناء الضمان الاجتماعي الإلزامي,متناهية الصغر,2,4,2,2,2,2,0
2023,1,المنطقة الشرقية,تمويل التأمين وإعادة التأمين وصناديق المعاشات التقاعدية باستثناء الضمان الاجتماعي الإلزامي,متوسطة,4,299,183,116,141,140,1
2023,1,منطقة الباحة,تمويل التأمين وإعادة التأمين وصناديق المعاشات التقاعدية باستثناء الضمان الاجتماعي الإلزامي,متناهية الصغر,1,0,0,0,4,4,0
2023,1,منطقة الرياض,تمويل التأمين وإعادة التأمين وصناديق المعاشات التقاعدية باستثناء الضمان الاجتماعي الإلزامي,صغيرة,6,100,78,22,37,36,1
2023,1,منطقة الرياض,تمويل التأمين وإعادة التأمين وصناديق المعاشات التقاعدية باستثناء الضمان الاجتماعي الإلزامي,كبيرة,7,3105,1907,1198,805,770,35
2023,1,منطقة الرياض,تمويل التأمين وإعادة التأمين وصناديق المعاشات التقاعدية باستثناء الضمان الاجتماعي الإلزامي,متناهية الصغر,26,24,10,14,13,13,0
2023,1,منطقة الرياض,تمويل التأمين وإعادة التأمين وصناديق المعاشات التقاعدية باستثناء الضمان الاجتماعي الإلزامي,متوسطة,9,931,679,252,342,327,15
2023,1,منطقة المدينة المنورة,تمويل التأمين وإعادة التأمين وصناديق المعاشات التقاعدية باستثناء الضمان الاجتماعي الإلزامي,متناهية الصغر,4,2,0,2,7,6,1
2023,1,منطقة جازان,تمويل التأمين وإعادة التأمين وصناديق المعاشات التقاعدية باستثناء الضمان الاجتماعي الإلزامي,متناهية الصغر,1,1,1,0,2,2,0
2023,1,منطقة عسير,تمويل التأمين وإعادة التأمين وصناديق المعاشات التقاعدية باستثناء الضمان الاجتماعي الإلزامي,متناهية الصغر,1,0,0,0,1,1,0
2023,1,منطقة مكة المكرمة,تمويل التأمين وإعادة التأمين وصناديق المعاشات التقاعدية باستثناء الضمان الاجتماعي الإلزامي,صغيرة,10,167,102,65,49,48,1
2023,1,منطقة مكة المكرمة,تمويل التأمين وإعادة التأمين وصناديق المعاشات التقاعدية باستثناء الضمان الاجتماعي الإلزامي,كبيرة,1,860,443,417,381,312,69
2023,1,منطقة مكة المكرمة,تمويل التأمين وإعادة التأمين وصناديق المعاشات التقاعدية باستثناء الضمان الاجتماعي الإلزامي,متناهية الصغر,8,1,1,0,10,10,0
2023,1,منطقة مكة المكرمة,تمويل التأمين وإعادة التأمين وصناديق المعاشات التقاعدية باستثناء الضمان الاجتماعي الإلزامي,متوسطة,5,626,393,233,224,215,9
2023,1,منطقة نجران,تمويل التأمين وإعادة التأمين وصناديق المعاشات التقاعدية باستثناء الضمان الاجتماعي الإلزامي,متناهية الصغر,2,0,0,0,5,5,0
2023,1,المنطقة الشرقية,التعدين,صغيرة,10,16,13,3,92,92,0
2023,1,المنطقة الشرقية,التعدين,كبيرة,1,570,566,4,3,3,0
2023,1,المنطقة الشرقية,التعدين,متناهية الصغر,55,18,12,6,115,115,0
2023,1,المنطقة الشرقية,التعدين,متوسطة,1,77,65,12,54,53,1
2023,1,منطقة الباحة,التعدين,متناهية الصغر,4,0,0,0,5,5,0
2023,1,منطقة الجوف,التعدين,متناهية الصغر,1,0,0,0,4,4,0
2023,1,منطقة الحدود الشمالية,التعدين,متناهية الصغر,3,0,0,0,7,7,0
2023,1,منطقة الرياض,التعدين,صغيرة,15,50,29,21,190,189,1
2023,1,منطقة الرياض,التعدين,متناهية الصغر,32,19,14,5,56,56,0
2023,1,منطقة الرياض,التعدين,متوسطة,2,66,30,36,94,94,0
2023,1,منطقة القصيم,التعدين,صغيرة,1,0,0,0,8,8,0
2023,1,منطقة القصيم,التعدين,متناهية الصغر,12,2,2,0,29,29,0
2023,1,منطقة القصيم,التعدين,متوسطة,1,90,90,0,14,14,0
2023,1,منطقة المدينة المنورة,التعدين,متناهية الصغر,7,1,1,0,15,15,0
2023,1,منطقة تبوك,التعدين,صغيرة,1,0,0,0,6,6,0
2023,1,منطقة جازان,التعدين,صغيرة,1,13,3,10,0,0,0
2023,1,منطقة جازان,التعدين,متناهية الصغر,7,0,0,0,21,21,0
2023,1,منطقة حائل,التعدين,متناهية الصغر,2,0,0,0,5,5,0
2023,1,منطقة عسير,التعدين,صغيرة,4,5,2,3,29,29,0
2023,1,منطقة عسير,التعدين,متناهية الصغر,33,5,4,1,62,62,0
2023,1,منطقة مكة المكرمة,التعدين,صغيرة,6,26,8,18,79,77,2
2023,1,منطقة مكة المكرمة,التعدين,متناهية الصغر,39,13,7,6,72,72,0
2023,1,منطقة مكة المكرمة,التعدين,متوسطة,4,414,384,30,52,52,0
2023,1,منطقة نجران,التعدين,صغيرة,1,0,0,0,13,13,0
2023,1,منطقة نجران,التعدين,متناهية الصغر,3,0,0,0,4,4,0
2023,1,المنطقة الشرقية,التعدين,صغيرة,2,5,5,0,13,13,0
2023,1,المنطقة الشرقية,التعدين,متناهية الصغر,5,3,3,0,8,8,0
2023,1,منطقة الرياض,التعدين,صغيرة,2,3,2,1,18,18,0
2023,1,منطقة الرياض,التعدين,متناهية الصغر,15,2,2,0,49,49,0
2023,1,منطقة الرياض,التعدين,متوسطة,2,69,30,39,63,63,0
2023,1,منطقة القصيم,التعدين,صغيرة,1,2,0,2,10,10,0
2023,1,منطقة القصيم,التعدين,متناهية الصغر,4,2,0,2,6,6,0
2023,1,منطقة حائل,التعدين,متناهية الصغر,1,0,0,0,4,4,0
2023,1,منطقة مكة المكرمة,التعدين,صغيرة,2,6,3,3,24,24,0
2023,1,منطقة مكة المكرمة,التعدين,متناهية الصغر,9,2,2,0,13,13,0
2023,1,منطقة نجران,التعدين,متناهية الصغر,1,0,0,0,4,4,0
2023,1,المنطقة الشرقية,الأنشطه المعماريه والهندسيه,صغيرة,5016,11316,5856,5460,67734,67530,204
2023,1,المنطقة الشرقية,الأنشطه المعماريه والهندسيه,كبيرة,139,25493,17518,7975,124966,124301,665
2023,1,المنطقة الشرقية,الأنشطه المعماريه والهندسيه,متناهية الصغر,12802,3061,1551,1510,30782,30671,111
2023,1,المنطقة الشرقية,الأنشطه المعماريه والهندسيه,متوسطة,753,11023,6412,4611,64350,64223,127
2023,1,منطقة الباحة,الأنشطه المعماريه والهندسيه,صغيرة,216,354,240,114,2130,2122,8
2023,1,منطقة الباحة,الأنشطه المعماريه والهندسيه,متناهية الصغر,1283,223,123,100,3233,3225,8
2023,1,منطقة الباحة,الأنشطه المعماريه والهندسيه,متوسطة,4,64,48,16,296,296,0
2023,1,منطقة الجوف,الأنشطه المعماريه والهندسيه,صغيرة,243,332,207,125,2547,2540,7
2023,1,منطقة الجوف,الأنشطه المعماريه والهندسيه,كبيرة,2,295,217,78,588,497,91
2023,1,منطقة الجوف,الأنشطه المعماريه والهندسيه,متناهية الصغر,1638,211,134,77,4020,4012,8
2023,1,منطقة الجوف,الأنشطه المعماريه والهندسيه,متوسطة,7,102,66,36,466,466,0
2023,1,منطقة الحدود الشمالية,الأنشطه المعماريه والهندسيه,صغيرة,176,275,160,115,1777,1771,6
2023,1,منطقة الحدود الشمالية,الأنشطه المعماريه والهندسيه,كبيرة,3,380,223,157,2379,2355,24
2023,1,منطقة الحدود الشمالية,الأنشطه المعماريه والهندسيه,متناهية الصغر,1609,146,79,67,4299,4291,8
2023,1,منطقة الحدود الشمالية,الأنشطه المعماريه والهندسيه,متوسطة,9,109,64,45,670,670,0
2023,1,منطقة الرياض,الأنشطه المعماريه والهندسيه,صغيرة,7032,15183,6597,8586,89963,89293,670
2023,1,منطقة الرياض,الأنشطه المعماريه والهندسيه,كبيرة,368,27021,14746,12275,227441,224833,2608
2023,1,منطقة الرياض,الأنشطه المعماريه والهندسيه,متناهية الصغر,24451,5546,2590,2956,54430,53972,458
2023,1,منطقة الرياض,الأنشطه المعماريه والهندسيه,متوسطة,1129,14300,6877,7423,105577,104648,929
2023,1,منطقة القصيم,الأنشطه المعماريه والهندسيه,صغيرة,1329,1977,1167,810,15978,15873,105
2023,1,منطقة القصيم,الأنشطه المعماريه والهندسيه,كبيرة,32,476,288,188,13854,13773,81
2023,1,منطقة القصيم,الأنشطه المعماريه والهندسيه,متناهية الصغر,9515,1039,574,465,22829,22784,45
2023,1,منطقة القصيم,الأنشطه المعماريه والهندسيه,متوسطة,156,1023,624,399,16680,16610,70
2023,1,منطقة المدينة المنورة,الأنشطه المعماريه والهندسيه,صغيرة,1305,2354,1307,1047,14418,14347,71
2023,1,منطقة المدينة المنورة,الأنشطه المعماريه والهندسيه,كبيرة,10,1531,645,886,13886,13416,470
2023,1,منطقة المدينة المنورة,الأنشطه المعماريه والهندسيه,متناهية الصغر,6165,985,547,438,15520,15456,64
2023,1,منطقة المدينة المنورة,الأنشطه المعماريه والهندسيه,متوسطة,74,1055,600,455,5920,5910,10
2023,1,منطقة تبوك,الأنشطه المعماريه والهندسيه,صغيرة,304,488,259,229,2952,2948,4
2023,1,منطقة تبوك,الأنشطه المعماريه والهندسيه,كبيرة,1,47,47,0,240,240,0
2023,1,منطقة تبوك,الأنشطه المعماريه والهندسيه,متناهية الصغر,2811,417,211,206,7224,7213,11
2023,1,منطقة تبوك,الأنشطه المعماريه والهندسيه,متوسطة,12,107,52,55,930,918,12
2023,1,منطقة جازان,الأنشطه المعماريه والهندسيه,صغيرة,365,595,294,301,3591,3583,8
2023,1,منطقة جازان,الأنشطه المعماريه والهندسيه,كبيرة,1,24,13,11,461,461,0
2023,1,منطقة جازان,الأنشطه المعماريه والهندسيه,متناهية الصغر,4244,520,281,239,11008,10981,27
2023,1,منطقة جازان,الأنشطه المعماريه والهندسيه,متوسطة,12,212,119,93,1020,1007,13
2023,1,منطقة حائل,الأنشطه المعماريه والهندسيه,صغيرة,381,507,231,276,4035,4016,19
2023,1,منطقة حائل,الأنشطه المعماريه والهندسيه,كبيرة,3,18,6,12,1083,1083,0
2023,1,منطقة حائل,الأنشطه المعماريه والهندسيه,متناهية الصغر,3182,352,186,166,7669,7650,19
2023,1,منطقة حائل,الأنشطه المعماريه والهندسيه,متوسطة,28,373,232,141,2352,2351,1
2023,1,منطقة عسير,الأنشطه المعماريه والهندسيه,صغيرة,981,1543,914,629,9636,9597,39
2023,1,منطقة عسير,الأنشطه المعماريه والهندسيه,كبيرة,3,307,292,15,1415,1415,0
2023,1,منطقة عسير,الأنشطه المعماريه والهندسيه,متناهية الصغر,8294,1156,656,500,19950,19918,32
2023,1,منطقة عسير,الأنشطه المعماريه والهندسيه,متوسطة,39,646,438,208,2947,2941,6
2023,1,منطقة مكة المكرمة,الأنشطه المعماريه والهندسيه,صغيرة,5237,9499,4530,4969,60552,60037,515
2023,1,منطقة مكة المكرمة,الأنشطه المعماريه والهندسيه,كبيرة,92,13017,9148,3869,88813,88090,723
2023,1,منطقة مكة المكرمة,الأنشطه المعماريه والهندسيه,متناهية الصغر,22418,4296,2120,2176,55057,54559,498
2023,1,منطقة مكة المكرمة,الأنشطه المعماريه والهندسيه,متوسطة,474,7235,4085,3150,39388,39055,333
2023,1,منطقة نجران,الأنشطه المعماريه والهندسيه,صغيرة,374,564,276,288,3989,3977,12
2023,1,منطقة نجران,الأنشطه المعماريه والهندسيه,كبيرة,8,938,479,459,2769,2761,8
2023,1,منطقة نجران,الأنشطه المعماريه والهندسيه,متناهية الصغر,2727,277,136,141,6447,6418,29
2023,1,منطقة نجران,الأنشطه المعماريه والهندسيه,متوسطة,44,674,424,250,4270,4268,2
2023,1,المنطقة الشرقية,تجميع المياه ومعالجتها وتوصيلها,صغيرة,35,162,113,49,407,407,0
2023,1,المنطقة الشرقية,تجميع المياه ومعالجتها وتوصيلها,كبيرة,2,812,800,12,212,212,0
2023,1,المنطقة الشرقية,تجميع المياه ومعالجتها وتوصيلها,متناهية الصغر,83,31,15,16,169,169,0
2023,1,المنطقة الشرقية,تجميع المياه ومعالجتها وتوصيلها,متوسطة,1,137,131,6,103,103,0
2023,1,منطقة الباحة,تجميع المياه ومعالجتها وتوصيلها,صغيرة,2,2,1,1,13,13,0
2023,1,منطقة الباحة,تجميع المياه ومعالجتها وتوصيلها,متناهية الصغر,30,5,3,2,56,56,0
2023,1,منطقة الجوف,تجميع المياه ومعالجتها وتوصيلها,صغيرة,2,9,6,3,35,35,0
2023,1,منطقة الجوف,تجميع المياه ومعالجتها وتوصيلها,متناهية الصغر,20,0,0,0,48,48,0
2023,1,منطقة الجوف,تجميع المياه ومعالجتها وتوصيلها,متوسطة,1,19,13,6,49,49,0
2023,1,منطقة الحدود الشمالية,تجميع المياه ومعالجتها وتوصيلها,صغيرة,5,4,3,1,35,35,0
2023,1,منطقة الحدود الشمالية,تجميع المياه ومعالجتها وتوصيلها,متناهية الصغر,17,3,3,0,42,42,0
2023,1,منطقة الرياض,تجميع المياه ومعالجتها وتوصيلها,صغيرة,61,222,121,101,586,585,1
2023,1,منطقة الرياض,تجميع المياه ومعالجتها وتوصيلها,كبيرة,2,264,218,46,556,551,5
2023,1,منطقة الرياض,تجميع المياه ومعالجتها وتوصيلها,متناهية الصغر,212,57,29,28,472,469,3
2023,1,منطقة الرياض,تجميع المياه ومعالجتها وتوصيلها,متوسطة,13,465,302,163,1024,1024,0
2023,1,منطقة القصيم,تجميع المياه ومعالجتها وتوصيلها,صغيرة,11,28,17,11,95,95,0
2023,1,منطقة القصيم,تجميع المياه ومعالجتها وتوصيلها,متناهية الصغر,62,10,6,4,140,140,0
2023,1,منطقة القصيم,تجميع المياه ومعالجتها وتوصيلها,متوسطة,2,138,108,30,222,222,0
2023,1,منطقة المدينة المنورة,تجميع المياه ومعالجتها وتوصيلها,صغيرة,10,30,22,8,94,94,0
2023,1,منطقة المدينة المنورة,تجميع المياه ومعالجتها وتوصيلها,كبيرة,1,730,730,0,183,183,0
2023,1,منطقة المدينة المنورة,تجميع المياه ومعالجتها وتوصيلها,متناهية الصغر,65,15,7,8,117,117,0
2023,1,منطقة المدينة المنورة,تجميع المياه ومعالجتها وتوصيلها,متوسطة,1,28,16,12,64,64,0
2023,1,منطقة تبوك,تجميع المياه ومعالجتها وتوصيلها,صغيرة,5,20,16,4,82,82,0
2023,1,منطقة تبوك,تجميع المياه ومعالجتها وتوصيلها,متناهية الصغر,50,9,4,5,102,101,1
2023,1,منطقة جازان,تجميع المياه ومعالجتها وتوصيلها,صغيرة,6,57,53,4,38,38,0
2023,1,منطقة جازان,تجميع المياه ومعالجتها وتوصيلها,متناهية الصغر,85,20,11,9,164,164,0
2023,1,منطقة جازان,تجميع المياه ومعالجتها وتوصيلها,متوسطة,1,54,52,2,26,26,0
2023,1,منطقة حائل,تجميع المياه ومعالجتها وتوصيلها,صغيرة,1,13,11,2,31,31,0
2023,1,منطقة حائل,تجميع المياه ومعالجتها وتوصيلها,متناهية الصغر,32,4,1,3,71,71,0
2023,1,منطقة حائل,تجميع المياه ومعالجتها وتوصيلها,متوسطة,2,28,22,6,112,112,0
2023,1,منطقة عسير,تجميع المياه ومعالجتها وتوصيلها,صغيرة,16,55,28,27,187,187,0
2023,1,منطقة عسير,تجميع المياه ومعالجتها وتوصيلها,متناهية الصغر,141,22,10,12,263,263,0
2023,1,منطقة مكة المكرمة,تجميع المياه ومعالجتها وتوصيلها,صغيرة,66,314,232,82,583,582,1
2023,1,منطقة مكة المكرمة,تجميع المياه ومعالجتها وتوصيلها,متناهية الصغر,385,74,37,37,831,828,3
2023,1,منطقة مكة المكرمة,تجميع المياه ومعالجتها وتوصيلها,متوسطة,11,672,598,74,540,539,1
2023,1,منطقة نجران,تجميع المياه ومعالجتها وتوصيلها,صغيرة,6,6,4,2,70,70,0
2023,1,منطقة نجران,تجميع المياه ومعالجتها وتوصيلها,كبيرة,1,81,62,19,198,195,3
2023,1,منطقة نجران,تجميع المياه ومعالجتها وتوصيلها,متناهية الصغر,25,6,3,3,50,50,0
2023,1,منطقة نجران,تجميع المياه ومعالجتها وتوصيلها,متوسطة,1,21,17,4,35,35,0
2023,1,المنطقة الشرقية,التجارة,صغيرة,1929,4480,2940,1540,17542,17519,23
2023,1,المنطقة الشرقية,التجارة,كبيرة,7,1057,901,156,1535,1533,2
2023,1,المنطقة الشرقية,التجارة,متناهية الصغر,7246,1955,1321,634,16975,16953,22
2023,1,المنطقة الشرقية,التجارة,متوسطة,64,1849,1435,414,3920,3919,1
2023,1,منطقة الباحة,التجارة,صغيرة,72,136,104,32,513,512,1
2023,1,منطقة الباحة,التجارة,متناهية الصغر,711,139,111,28,1580,1579,1
2023,1,منطقة الجوف,التجارة,صغيرة,117,202,162,40,949,948,1
2023,1,منطقة الجوف,التجارة,متناهية الصغر,1045,163,120,43,2463,2458,5
2023,1,منطقة الحدود الشمالية,التجارة,صغيرة,72,141,85,56,570,567,3
2023,1,منطقة الحدود الشمالية,التجارة,متناهية الصغر,726,107,84,23,1734,1733,1
2023,1,منطقة الرياض,التجارة,صغيرة,2798,7414,3843,3571,27353,27260,93
2023,1,منطقة الرياض,التجارة,كبيرة,9,1812,1580,232,4325,4320,5
2023,1,منطقة الرياض,التجارة,متناهية الصغر,14216,2859,1630,1229,33390,33265,125
2023,1,منطقة الرياض,التجارة,متوسطة,121,2983,1928,1055,8147,8107,40
2023,1,منطقة القصيم,التجارة,صغيرة,518,1238,893,345,4709,4707,2
2023,1,منطقة القصيم,التجارة,كبيرة,1,0,0,0,251,251,0
2023,1,منطقة القصيم,التجارة,متناهية الصغر,3658,588,413,175,8445,8438,7
2023,1,منطقة القصيم,التجارة,متوسطة,7,87,56,31,391,391,0
2023,1,منطقة المدينة المنورة,التجارة,صغيرة,381,807,560,247,2986,2978,8
2023,1,منطقة المدينة المنورة,التجارة,متناهية الصغر,3443,633,443,190,8078,8066,12
2023,1,منطقة المدينة المنورة,التجارة,متوسطة,3,61,44,17,250,250,0
2023,1,منطقة تبوك,التجارة,صغيرة,181,366,276,90,1454,1452,2
2023,1,منطقة تبوك,التجارة,متناهية الصغر,1744,263,178,85,4221,4215,6
2023,1,منطقة تبوك,التجارة,متوسطة,3,48,38,10,154,154,0
2023,1,منطقة جازان,التجارة,صغيرة,163,375,278,97,1329,1326,3
2023,1,منطقة جازان,التجارة,كبيرة,1,121,111,10,229,229,0
2023,1,منطقة جازان,التجارة,متناهية الصغر,2756,353,248,105,6532,6523,9
2023,1,منطقة جازان,التجارة,متوسطة,4,76,61,15,232,231,1
2023,1,منطقة حائل,التجارة,صغيرة,213,450,292,158,1918,1917,1
2023,1,منطقة حائل,التجارة,متناهية الصغر,1394,209,138,71,3274,3270,4
2023,1,منطقة حائل,التجارة,متوسطة,2,40,26,14,107,107,0
2023,1,منطقة عسير,التجارة,صغيرة,528,1175,801,374,4561,4559,2
2023,1,منطقة عسير,التجارة,متناهية الصغر,4187,704,500,204,9718,9694,24
2023,1,منطقة عسير,التجارة,متوسطة,9,215,184,31,480,480,0
2023,1,منطقة مكة المكرمة,التجارة,صغيرة,1633,4245,2751,1494,14547,14491,56
2023,1,منطقة مكة المكرمة,التجارة,كبيرة,20,3970,3233,737,6688,6657,31
2023,1,منطقة مكة المكرمة,التجارة,متناهية الصغر,11488,2133,1349,784,27172,27040,132
2023,1,منطقة مكة المكرمة,التجارة,متوسطة,77,2648,2121,527,4981,4963,18
2023,1,منطقة نجران,التجارة,صغيرة,97,222,133,89,937,936,1
2023,1,منطقة نجران,التجارة,متناهية الصغر,914,128,77,51,2220,2214,6
2023,1,منطقة نجران,التجارة,متوسطة,3,53,25,28,130,129,1
2023,1,المنطقة الشرقية,التجارة,صغيرة,2322,9336,5154,4182,21830,21745,85
2023,1,المنطقة الشرقية,التجارة,كبيرة,14,3854,2428,1426,3977,3967,10
2023,1,المنطقة الشرقية,التجارة,متناهية الصغر,6642,3557,1969,1588,12805,12721,84
2023,1,المنطقة الشرقية,التجارة,متوسطة,184,6688,4308,2380,11719,11625,94
2023,1,منطقة الباحة,التجارة,صغيرة,87,273,179,94,733,732,1
2023,1,منطقة الباحة,التجارة,متناهية الصغر,422,167,118,49,810,805,5
2023,1,منطقة الباحة,التجارة,متوسطة,2,48,33,15,88,88,0
2023,1,منطقة الجوف,التجارة,صغيرة,117,325,209,116,998,996,2
2023,1,منطقة الجوف,التجارة,متناهية الصغر,643,195,131,64,1305,1300,5
2023,1,منطقة الجوف,التجارة,متوسطة,2,99,31,68,162,161,1
2023,1,منطقة الحدود الشمالية,التجارة,صغيرة,48,123,70,53,357,356,1
2023,1,منطقة الحدود الشمالية,التجارة,متناهية الصغر,407,111,67,44,879,878,1
2023,1,منطقة الحدود الشمالية,التجارة,متوسطة,1,0,0,0,108,108,0
2023,1,منطقة الرياض,التجارة,صغيرة,5411,22267,9981,12286,53693,53022,671
2023,1,منطقة الرياض,التجارة,كبيرة,57,19601,11956,7645,19388,19003,385
2023,1,منطقة الرياض,التجارة,متناهية الصغر,17008,6863,3249,3614,33868,33360,508
2023,1,منطقة الرياض,التجارة,متوسطة,430,14732,7455,7277,25885,25482,403
2023,1,منطقة القصيم,التجارة,صغيرة,435,1552,935,617,3988,3970,18
2023,1,منطقة القصيم,التجارة,كبيرة,1,290,82,208,7,7,0
2023,1,منطقة القصيم,التجارة,متناهية الصغر,2238,759,500,259,4519,4493,26
2023,1,منطقة القصيم,التجارة,متوسطة,25,419,281,138,1597,1579,18
2023,1,منطقة المدينة المنورة,التجارة,صغيرة,644,2215,1335,880,5323,5285,38
2023,1,منطقة المدينة المنورة,التجارة,متناهية الصغر,3105,990,591,399,6409,6351,58
2023,1,منطقة المدينة المنورة,التجارة,متوسطة,18,525,337,188,1051,1048,3
2023,1,منطقة تبوك,التجارة,صغيرة,159,614,323,291,1514,1511,3
2023,1,منطقة تبوك,التجارة,متناهية الصغر,936,322,169,153,1824,1815,9
2023,1,منطقة تبوك,التجارة,متوسطة,9,190,121,69,510,508,2
2023,1,منطقة جازان,التجارة,صغيرة,253,843,473,370,2369,2366,3
2023,1,منطقة جازان,التجارة,متناهية الصغر,1803,425,259,166,3904,3882,22
2023,1,منطقة جازان,التجارة,متوسطة,5,86,63,23,352,350,2
2023,1,منطقة حائل,التجارة,صغيرة,160,553,279,274,1413,1404,9
2023,1,منطقة حائل,التجارة,متناهية الصغر,760,219,134,85,1624,1618,6
2023,1,منطقة حائل,التجارة,متوسطة,4,79,62,17,185,185,0
2023,1,منطقة عسير,التجارة,صغيرة,527,1898,1220,678,4713,4707,6
2023,1,منطقة عسير,التجارة,متناهية الصغر,2279,863,553,310,4794,4768,26
2023,1,منطقة عسير,التجارة,متوسطة,18,516,321,195,952,946,6
2023,1,منطقة مكة المكرمة,التجارة,صغيرة,4868,18902,8933,9969,47978,47330,648
2023,1,منطقة مكة المكرمة,التجارة,كبيرة,36,7361,5245,2116,9129,8946,183
2023,1,منطقة مكة المكرمة,التجارة,متناهية الصغر,15126,5562,2756,2806,31487,30903,584
2023,1,منطقة مكة المكرمة,التجارة,متوسطة,358,12727,6879,5848,21257,20943,314
2023,1,منطقة نجران,التجارة,صغيرة,106,345,189,156,979,966,13
2023,1,منطقة نجران,التجارة,متناهية الصغر,627,164,92,72,1432,1424,8
2023,1,منطقة نجران,التجارة,متوسطة,6,152,91,61,286,286,0
2023,1,المنطقة الشرقية,التجارة,صغيرة,3503,12795,6108,6687,30546,30333,213
2023,1,المنطقة الشرقية,التجارة,كبيرة,28,7321,3802,3519,10785,10028,757
2023,1,المنطقة الشرقية,التجارة,متناهية الصغر,17541,7471,3790,3681,34790,34568,222
2023,1,المنطقة الشرقية,التجارة,متوسطة,206,6991,3526,3465,13068,12993,75
2023,1,منطقة الباحة,التجارة,صغيرة,239,750,478,272,1781,1779,2
2023,1,منطقة الباحة,التجارة,متناهية الصغر,1601,596,377,219,2938,2925,13
2023,1,منطقة الباحة,التجارة,متوسطة,4,72,54,18,171,171,0
2023,1,منطقة الجوف,التجارة,صغيرة,301,805,480,325,2367,2341,26
2023,1,منطقة الجوف,التجارة,متناهية الصغر,2591,714,454,260,5120,5100,20
2023,1,منطقة الجوف,التجارة,متوسطة,6,178,66,112,348,348,0
2023,1,منطقة الحدود الشمالية,التجارة,صغيرة,168,463,225,238,1322,1312,10
2023,1,منطقة الحدود الشمالية,التجارة,متناهية الصغر,1952,462,249,213,4035,4016,19
2023,1,منطقة الحدود الشمالية,التجارة,متوسطة,4,63,43,20,301,293,8
2023,1,منطقة الرياض,التجارة,صغيرة,7120,28831,12161,16670,69736,68715,1021
2023,1,منطقة الرياض,التجارة,كبيرة,100,34209,18792,15417,47682,47059,623
2023,1,منطقة الرياض,التجارة,متناهية الصغر,33690,11379,5417,5962,70093,69126,967
2023,1,منطقة الرياض,التجارة,متوسطة,603,19870,8906,10964,37666,36920,746
2023,1,منطقة القصيم,التجارة,صغيرة,1069,3747,2356,1391,9530,9485,45
2023,1,منطقة القصيم,التجارة,كبيرة,3,434,147,287,992,992,0
2023,1,منطقة القصيم,التجارة,متناهية الصغر,6874,2239,1368,871,13818,13745,73
2023,1,منطقة القصيم,التجارة,متوسطة,58,1354,793,561,3359,3355,4
2023,1,منطقة المدينة المنورة,التجارة,صغيرة,1361,4678,2537,2141,10691,10625,66
2023,1,منطقة المدينة المنورة,التجارة,كبيرة,1,89,50,39,233,233,0
2023,1,منطقة المدينة المنورة,التجارة,متناهية الصغر,10349,3160,1917,1243,21572,21357,215
2023,1,منطقة المدينة المنورة,التجارة,متوسطة,54,1627,706,921,3005,2970,35
2023,1,منطقة تبوك,التجارة,صغيرة,423,1332,662,670,3106,3092,14
2023,1,منطقة تبوك,التجارة,كبيرة,1,162,128,34,231,231,0
2023,1,منطقة تبوك,التجارة,متناهية الصغر,3972,1124,597,527,7966,7929,37
2023,1,منطقة تبوك,التجارة,متوسطة,7,370,134,236,448,448,0
2023,1,منطقة جازان,التجارة,صغيرة,738,2217,1172,1045,6027,6005,22
2023,1,منطقة جازان,التجارة,متناهية الصغر,7362,1935,1100,835,15228,15122,106
2023,1,منطقة جازان,التجارة,متوسطة,16,728,277,451,885,873,12
2023,1,منطقة حائل,التجارة,صغيرة,403,1236,609,627,3415,3386,29
2023,1,منطقة حائل,التجارة,كبيرة,1,170,76,94,267,267,0
2023,1,منطقة حائل,التجارة,متناهية الصغر,3449,1004,507,497,6975,6937,38
2023,1,منطقة حائل,التجارة,متوسطة,13,305,101,204,604,603,1
2023,1,منطقة عسير,التجارة,صغيرة,1213,4091,2186,1905,9738,9704,34
2023,1,منطقة عسير,التجارة,كبيرة,2,408,182,226,447,444,3
2023,1,منطقة عسير,التجارة,متناهية الصغر,9539,3128,1976,1152,18797,18703,94
2023,1,منطقة عسير,التجارة,متوسطة,32,865,376,489,1746,1707,39
2023,1,منطقة مكة المكرمة,التجارة,صغيرة,6140,23510,10406,13104,54797,54023,774
2023,1,منطقة مكة المكرمة,التجارة,كبيرة,40,11187,5212,5975,12398,12004,394
2023,1,منطقة مكة المكرمة,التجارة,متناهية الصغر,34011,10938,5658,5280,71725,70587,1138
2023,1,منطقة مكة المكرمة,التجارة,متوسطة,394,13461,6748,6713,23575,23181,394
2023,1,منطقة نجران,التجارة,صغيرة,308,859,398,461,2601,2579,22
2023,1,منطقة نجران,التجارة,متناهية الصغر,2678,552,277,275,5683,5648,35
2023,1,منطقة نجران,التجارة,متوسطة,9,299,97,202,633,627,6
2023,1,المنطقة الشرقية,الخدمات,صغيرة,265,365,193,172,3031,3026,5
2023,1,المنطقة الشرقية,الخدمات,كبيرة,3,1840,1288,552,9667,9648,19
2023,1,المنطقة الشرقية,الخدمات,متناهية الصغر,1881,261,139,122,2816,2812,4
2023,1,المنطقة الشرقية,الخدمات,متوسطة,23,390,256,134,1908,1903,5
2023,1,منطقة الباحة,الخدمات,صغيرة,7,8,8,0,43,43,0
2023,1,منطقة الباحة,الخدمات,متناهية الصغر,164,12,8,4,201,201,0
2023,1,منطقة الجوف,الخدمات,صغيرة,21,46,25,21,196,196,0
2023,1,منطقة الجوف,الخدمات,كبيرة,1,118,108,10,799,796,3
2023,1,منطقة الجوف,الخدمات,متناهية الصغر,809,42,25,17,1158,1152,6
2023,1,منطقة الجوف,الخدمات,متوسطة,1,1,1,0,63,63,0
2023,1,منطقة الحدود الشمالية,الخدمات,صغيرة,2,1,1,0,15,15,0
2023,1,منطقة الحدود الشمالية,الخدمات,متناهية الصغر,86,8,4,4,101,101,0
2023,1,منطقة الرياض,الخدمات,صغيرة,485,907,399,508,6562,6516,46
2023,1,منطقة الرياض,الخدمات,كبيرة,19,2096,1781,315,16388,16373,15
2023,1,منطقة الرياض,الخدمات,متناهية الصغر,7311,598,276,322,12973,12913,60
2023,1,منطقة الرياض,الخدمات,متوسطة,90,983,428,555,8211,8161,50
2023,1,منطقة القصيم,الخدمات,صغيرة,93,171,94,77,1258,1253,5
2023,1,منطقة القصيم,الخدمات,كبيرة,3,1491,1114,377,6001,6000,1
2023,1,منطقة القصيم,الخدمات,متناهية الصغر,1274,146,96,50,1884,1876,8
2023,1,منطقة القصيم,الخدمات,متوسطة,15,207,144,63,1481,1479,2
2023,1,منطقة المدينة المنورة,الخدمات,صغيرة,48,82,50,32,546,543,3
2023,1,منطقة المدينة المنورة,الخدمات,متناهية الصغر,885,92,63,29,1248,1240,8
2023,1,منطقة المدينة المنورة,الخدمات,متوسطة,4,59,36,23,340,340,0
2023,1,منطقة تبوك,الخدمات,صغيرة,34,27,14,13,472,472,0
2023,1,منطقة تبوك,الخدمات,كبيرة,2,216,133,83,1189,1188,1
2023,1,منطقة تبوك,الخدمات,متناهية الصغر,857,50,29,21,1091,1091,0
2023,1,منطقة تبوك,الخدمات,متوسطة,2,0,0,0,121,121,0
2023,1,منطقة جازان,الخدمات,صغيرة,32,37,22,15,351,349,2
2023,1,منطقة جازان,الخدمات,متناهية الصغر,766,27,21,6,1279,1275,4
2023,1,منطقة جازان,الخدمات,متوسطة,1,5,4,1,50,50,0
2023,1,منطقة حائل,الخدمات,صغيرة,45,39,24,15,497,494,3
2023,1,منطقة حائل,الخدمات,كبيرة,2,675,662,13,2076,2075,1
2023,1,منطقة حائل,الخدمات,متناهية الصغر,1495,69,37,32,2696,2690,6
2023,1,منطقة حائل,الخدمات,متوسطة,6,43,26,17,539,539,0
2023,1,منطقة عسير,الخدمات,صغيرة,62,78,52,26,698,696,2
2023,1,منطقة عسير,الخدمات,متناهية الصغر,1139,64,39,25,1433,1431,2
2023,1,منطقة عسير,الخدمات,متوسطة,6,51,34,17,555,555,0
2023,1,منطقة مكة المكرمة,الخدمات,صغيرة,107,147,74,73,1126,1114,12
2023,1,منطقة مكة المكرمة,الخدمات,كبيرة,3,492,285,207,2683,2682,1
2023,1,منطقة مكة المكرمة,الخدمات,متناهية الصغر,2098,134,66,68,3095,3085,10
2023,1,منطقة مكة المكرمة,الخدمات,متوسطة,9,85,38,47,733,646,87
2023,1,منطقة نجران,الخدمات,صغيرة,19,18,9,9,217,217,0
2023,1,منطقة نجران,الخدمات,متناهية الصغر,703,18,8,10,1035,1029,6
2023,1,منطقة نجران,الخدمات,متوسطة,2,8,7,1,194,194,0
2023,1,المنطقة الشرقية,الخدمات,صغيرة,57,481,391,90,633,625,8
2023,1,المنطقة الشرقية,الخدمات,كبيرة,27,28346,27222,1124,11464,11444,20
2023,1,المنطقة الشرقية,الخدمات,متناهية الصغر,77,93,66,27,93,92,1
2023,1,المنطقة الشرقية,الخدمات,متوسطة,23,1405,1294,111,1070,1064,6
2023,1,منطقة الباحة,الخدمات,متناهية الصغر,3,0,0,0,6,6,0
2023,1,منطقة الجوف,الخدمات,متناهية الصغر,6,0,0,0,12,12,0
2023,1,منطقة الحدود الشمالية,الخدمات,صغيرة,2,5,3,2,24,24,0
2023,1,منطقة الرياض,الخدمات,صغيرة,11,73,46,27,150,150,0
2023,1,منطقة الرياض,الخدمات,كبيرة,1,538,426,112,127,127,0
2023,1,منطقة الرياض,الخدمات,متناهية الصغر,46,68,48,20,35,35,0
2023,1,منطقة الرياض,الخدمات,متوسطة,2,87,74,13,158,156,2
2023,1,منطقة القصيم,الخدمات,متناهية الصغر,4,2,1,1,13,13,0
2023,1,منطقة المدينة المنورة,الخدمات,متناهية الصغر,4,1,1,0,4,4,0
2023,1,منطقة تبوك,الخدمات,صغيرة,1,3,2,1,13,13,0
2023,1,منطقة تبوك,الخدمات,متناهية الصغر,1,0,0,0,1,1,0
2023,1,منطقة جازان,الخدمات,صغيرة,1,0,0,0,22,22,0
2023,1,منطقة جازان,الخدمات,متناهية الصغر,3,0,0,0,8,8,0
2023,1,منطقة حائل,الخدمات,متناهية الصغر,4,0,0,0,8,8,0
2023,1,منطقة عسير,الخدمات,متناهية الصغر,14,2,1,1,28,28,0
2023,1,منطقة مكة المكرمة,الخدمات,صغيرة,9,38,26,12,68,65,3
2023,1,منطقة مكة المكرمة,الخدمات,كبيرة,2,294,160,134,625,624,1
2023,1,منطقة مكة المكرمة,الخدمات,متناهية الصغر,31,13,10,3,49,49,0
2023,1,منطقة مكة المكرمة,الخدمات,متوسطة,3,289,248,41,177,175,2
2023,1,منطقة نجران,الخدمات,متناهية الصغر,1,1,1,0,0,0,0
2023,1,المنطقة الشرقية,الخدمات,صغيرة,21,118,66,52,142,139,3
2023,1,المنطقة الشرقية,الخدمات,متناهية الصغر,40,36,17,19,48,47,1
2023,1,المنطقة الشرقية,الخدمات,متوسطة,6,589,312,277,146,142,4
2023,1,منطقة الجوف,الخدمات,صغيرة,1,0,0,0,7,7,0
2023,1,منطقة الجوف,الخدمات,متناهية الصغر,4,1,0,1,6,6,0
2023,1,منطقة الحدود الشمالية,الخدمات,متناهية الصغر,1,0,0,0,1,1,0
2023,1,منطقة الرياض,الخدمات,صغيرة,157,1217,614,603,1449,1383,66
2023,1,منطقة الرياض,الخدمات,كبيرة,7,6360,3366,2994,2781,2697,84
2023,1,منطقة الرياض,الخدمات,متناهية الصغر,252,236,130,106,343,326,17
2023,1,منطقة الرياض,الخدمات,متوسطة,41,2530,1461,1069,2064,1977,87
2023,1,منطقة القصيم,الخدمات,صغيرة,2,4,2,2,22,22,0
2023,1,منطقة القصيم,الخدمات,متناهية الصغر,8,5,3,2,11,11,0
2023,1,منطقة المدينة المنورة,الخدمات,صغيرة,2,3,0,3,10,10,0
2023,1,منطقة المدينة المنورة,الخدمات,متناهية الصغر,17,11,5,6,22,21,1
2023,1,منطقة المدينة المنورة,الخدمات,متوسطة,1,54,19,35,7,6,1
2023,1,منطقة تبوك,الخدمات,صغيرة,1,2,1,1,4,4,0
2023,1,منطقة تبوك,الخدمات,متناهية الصغر,8,4,1,3,9,9,0
2023,1,منطقة جازان,الخدمات,متناهية الصغر,4,1,0,1,9,9,0
2023,1,منطقة حائل,الخدمات,صغيرة,1,4,1,3,5,5,0
2023,1,منطقة حائل,الخدمات,متناهية الصغر,3,0,0,0,10,10,0
2023,1,منطقة عسير,الخدمات,صغيرة,1,3,0,3,3,2,1
2023,1,منطقة عسير,الخدمات,متناهية الصغر,7,2,1,1,9,9,0
2023,1,منطقة مكة المكرمة,الخدمات,صغيرة,48,329,139,190,420,406,14
2023,1,منطقة مكة المكرمة,الخدمات,متناهية الصغر,124,75,34,41,192,182,10
2023,1,منطقة مكة المكرمة,الخدمات,متوسطة,4,255,97,158,189,166,23
2023,1,منطقة نجران,الخدمات,متناهية الصغر,1,0,0,0,1,1,0
2023,1,المنطقة الشرقية,الخدمات,صغيرة,3851,10713,4922,5791,39242,39070,172
2023,1,المنطقة الشرقية,الخدمات,كبيرة,18,2904,1973,931,6468,6391,77
2023,1,المنطقة الشرقية,الخدمات,متناهية الصغر,9411,3225,1454,1771,21273,21165,108
2023,1,المنطقة الشرقية,الخدمات,متوسطة,208,4683,1864,2819,13887,13831,56
2023,1,منطقة الباحة,الخدمات,صغيرة,228,510,345,165,2068,2055,13
2023,1,منطقة الباحة,الخدمات,متناهية الصغر,893,271,179,92,1959,1950,9
2023,1,منطقة الباحة,الخدمات,متوسطة,2,72,47,25,193,192,1
2023,1,منطقة الجوف,الخدمات,صغيرة,222,516,331,185,2166,2163,3
2023,1,منطقة الجوف,الخدمات,متناهية الصغر,1173,228,129,99,2648,2633,15
2023,1,منطقة الجوف,الخدمات,متوسطة,5,93,59,34,239,237,2
2023,1,منطقة الحدود الشمالية,الخدمات,صغيرة,149,328,182,146,1575,1569,6
2023,1,منطقة الحدود الشمالية,الخدمات,متناهية الصغر,1158,188,99,89,2873,2859,14
2023,1,منطقة الحدود الشمالية,الخدمات,متوسطة,4,58,19,39,272,265,7
2023,1,منطقة الرياض,الخدمات,صغيرة,4783,15050,6001,9049,54729,54095,634
2023,1,منطقة الرياض,الخدمات,كبيرة,68,18671,11924,6747,40741,39914,827
2023,1,منطقة الرياض,الخدمات,متناهية الصغر,13735,3999,1758,2241,30721,30420,301
2023,1,منطقة الرياض,الخدمات,متوسطة,482,11127,4462,6665,33197,32763,434
2023,1,منطقة القصيم,الخدمات,صغيرة,888,2184,1367,817,8945,8926,19
2023,1,منطقة القصيم,الخدمات,كبيرة,1,64,47,17,187,187,0
2023,1,منطقة القصيم,الخدمات,متناهية الصغر,4323,811,491,320,10796,10767,29
2023,1,منطقة القصيم,الخدمات,متوسطة,34,652,353,299,1977,1976,1
2023,1,منطقة المدينة المنورة,الخدمات,صغيرة,1242,3111,1664,1447,11777,11722,55
2023,1,منطقة المدينة المنورة,الخدمات,كبيرة,2,200,162,38,523,521,2
2023,1,منطقة المدينة المنورة,الخدمات,متناهية الصغر,5614,1337,735,602,12630,12532,98
2023,1,منطقة المدينة المنورة,الخدمات,متوسطة,33,654,406,248,1794,1788,6
2023,1,منطقة تبوك,الخدمات,صغيرة,451,1140,512,628,4590,4566,24
2023,1,منطقة تبوك,الخدمات,كبيرة,2,177,57,120,485,444,41
2023,1,منطقة تبوك,الخدمات,متناهية الصغر,2472,472,223,249,5715,5688,27
2023,1,منطقة تبوك,الخدمات,متوسطة,11,233,116,117,752,751,1
2023,1,منطقة جازان,الخدمات,صغيرة,677,1675,863,812,6323,6308,15
2023,1,منطقة جازان,الخدمات,متناهية الصغر,4697,877,464,413,10465,10418,47
2023,1,منطقة جازان,الخدمات,متوسطة,15,209,111,98,772,772,0
2023,1,منطقة حائل,الخدمات,صغيرة,326,695,368,327,3147,3122,25
2023,1,منطقة حائل,الخدمات,كبيرة,2,163,64,99,502,496,6
2023,1,منطقة حائل,الخدمات,متناهية الصغر,1950,327,182,145,4587,4565,22
2023,1,منطقة حائل,الخدمات,متوسطة,13,189,104,85,830,827,3
2023,1,منطقة عسير,الخدمات,صغيرة,1313,3342,1819,1523,12971,12949,22
2023,1,منطقة عسير,الخدمات,متناهية الصغر,6388,1448,758,690,14701,14624,77
2023,1,منطقة عسير,الخدمات,متوسطة,48,894,466,428,2591,2574,17
2023,1,منطقة مكة المكرمة,الخدمات,صغيرة,4536,13076,5942,7134,48590,48016,574
2023,1,منطقة مكة المكرمة,الخدمات,كبيرة,24,6115,4156,1959,13968,13746,222
2023,1,منطقة مكة المكرمة,الخدمات,متناهية الصغر,17409,4476,2079,2397,38392,37857,535
2023,1,منطقة مكة المكرمة,الخدمات,متوسطة,301,6654,3174,3480,19158,18876,282
2023,1,منطقة نجران,الخدمات,صغيرة,217,479,192,287,2330,2318,12
2023,1,منطقة نجران,الخدمات,كبيرة,1,131,65,66,384,382,2
2023,1,منطقة نجران,الخدمات,متناهية الصغر,1623,261,84,177,3806,3784,22
2023,1,منطقة نجران,الخدمات,متوسطة,8,171,63,108,598,595,3
2023,1,المنطقة الشرقية,أنشطة جمع النفايات ومعالجتها وتصريفها ، واسترجاع المواد,صغيرة,50,166,88,78,622,620,2
2023,1,المنطقة الشرقية,أنشطة جمع النفايات ومعالجتها وتصريفها ، واسترجاع المواد,كبيرة,3,1494,886,608,5544,4260,1284
2023,1,المنطقة الشرقية,أنشطة جمع النفايات ومعالجتها وتصريفها ، واسترجاع المواد,متناهية الصغر,50,31,20,11,96,96,0
2023,1,المنطقة الشرقية,أنشطة جمع النفايات ومعالجتها وتصريفها ، واسترجاع المواد,متوسطة,16,353,234,119,1344,1342,2
2023,1,منطقة الباحة,أنشطة جمع النفايات ومعالجتها وتصريفها ، واسترجاع المواد,متناهية الصغر,1,0,0,0,2,2,0
2023,1,منطقة الجوف,أنشطة جمع النفايات ومعالجتها وتصريفها ، واسترجاع المواد,صغيرة,1,2,0,2,13,13,0
2023,1,منطقة الجوف,أنشطة جمع النفايات ومعالجتها وتصريفها ، واسترجاع المواد,متناهية الصغر,3,2,2,0,2,2,0
2023,1,منطقة الرياض,أنشطة جمع النفايات ومعالجتها وتصريفها ، واسترجاع المواد,صغيرة,53,192,89,103,834,827,7
2023,1,منطقة الرياض,أنشطة جمع النفايات ومعالجتها وتصريفها ، واسترجاع المواد,كبيرة,12,5553,3554,1999,39461,37815,1646
2023,1,منطقة الرياض,أنشطة جمع النفايات ومعالجتها وتصريفها ، واسترجاع المواد,متناهية الصغر,124,40,20,20,274,271,3
2023,1,منطقة الرياض,أنشطة جمع النفايات ومعالجتها وتصريفها ، واسترجاع المواد,متوسطة,14,267,183,84,1480,1480,0
2023,1,منطقة القصيم,أنشطة جمع النفايات ومعالجتها وتصريفها ، واسترجاع المواد,صغيرة,10,37,20,17,127,127,0
2023,1,منطقة القصيم,أنشطة جمع النفايات ومعالجتها وتصريفها ، واسترجاع المواد,متناهية الصغر,14,4,1,3,30,30,0
2023,1,منطقة القصيم,أنشطة جمع النفايات ومعالجتها وتصريفها ، واسترجاع المواد,متوسطة,2,25,16,9,160,111,49
2023,1,منطقة المدينة المنورة,أنشطة جمع النفايات ومعالجتها وتصريفها ، واسترجاع المواد,صغيرة,5,12,9,3,84,83,1
2023,1,منطقة المدينة المنورة,أنشطة جمع النفايات ومعالجتها وتصريفها ، واسترجاع المواد,كبيرة,2,428,279,149,1247,1152,95
2023,1,منطقة المدينة المنورة,أنشطة جمع النفايات ومعالجتها وتصريفها ، واسترجاع المواد,متناهية الصغر,12,8,2,6,22,22,0
2023,1,منطقة المدينة المنورة,أنشطة جمع النفايات ومعالجتها وتصريفها ، واسترجاع المواد,متوسطة,3,48,31,17,206,206,0
2023,1,منطقة تبوك,أنشطة جمع النفايات ومعالجتها وتصريفها ، واسترجاع المواد,متناهية الصغر,5,3,2,1,11,11,0
2023,1,منطقة جازان,أنشطة جمع النفايات ومعالجتها وتصريفها ، واسترجاع المواد,صغيرة,6,14,10,4,77,77,0
2023,1,منطقة جازان,أنشطة جمع النفايات ومعالجتها وتصريفها ، واسترجاع المواد,متناهية الصغر,5,1,0,1,9,9,0
2023,1,منطقة جازان,أنشطة جمع النفايات ومعالجتها وتصريفها ، واسترجاع المواد,متوسطة,1,16,5,11,62,62,0
2023,1,منطقة حائل,أنشطة جمع النفايات ومعالجتها وتصريفها ، واسترجاع المواد,صغيرة,1,1,0,1,5,5,0
2023,1,منطقة حائل,أنشطة جمع النفايات ومعالجتها وتصريفها ، واسترجاع المواد,متناهية الصغر,8,3,2,1,18,18,0
2023,1,منطقة عسير,أنشطة جمع النفايات ومعالجتها وتصريفها ، واسترجاع المواد,صغيرة,3,6,2,4,41,41,0
2023,1,منطقة عسير,أنشطة جمع النفايات ومعالجتها وتصريفها ، واسترجاع المواد,كبيرة,1,37,29,8,296,296,0
2023,1,منطقة عسير,أنشطة جمع النفايات ومعالجتها وتصريفها ، واسترجاع المواد,متناهية الصغر,19,6,3,3,29,29,0
2023,1,منطقة عسير,أنشطة جمع النفايات ومعالجتها وتصريفها ، واسترجاع المواد,متوسطة,2,132,70,62,156,156,0
2023,1,منطقة مكة المكرمة,أنشطة جمع النفايات ومعالجتها وتصريفها ، واسترجاع المواد,صغيرة,56,150,69,81,746,739,7
2023,1,منطقة مكة المكرمة,أنشطة جمع النفايات ومعالجتها وتصريفها ، واسترجاع المواد,كبيرة,5,2053,1189,864,5926,5867,59
2023,1,منطقة مكة المكرمة,أنشطة جمع النفايات ومعالجتها وتصريفها ، واسترجاع المواد,متناهية الصغر,93,50,26,24,193,191,2
2023,1,منطقة مكة المكرمة,أنشطة جمع النفايات ومعالجتها وتصريفها ، واسترجاع المواد,متوسطة,5,71,49,22,315,313,2
2023,1,منطقة نجران,أنشطة جمع النفايات ومعالجتها وتصريفها ، واسترجاع المواد,صغيرة,1,2,0,2,13,13,0
2023,1,منطقة نجران,أنشطة جمع النفايات ومعالجتها وتصريفها ، واسترجاع المواد,متناهية الصغر,12,2,0,2,32,32,0
2023,1,المنطقة الشرقية,الخدمات,صغيرة,508,1461,746,715,6624,6524,100
2023,1,المنطقة الشرقية,الخدمات,كبيرة,75,15564,10848,4716,69392,67949,1443
2023,1,المنطقة الشرقية,الخدمات,متناهية الصغر,1187,386,208,178,2491,2472,19
2023,1,المنطقة الشرقية,الخدمات,متوسطة,146,3082,2062,1020,13606,13213,393
2023,1,منطقة الباحة,الخدمات,صغيرة,7,19,13,6,65,65,0
2023,1,منطقة الباحة,الخدمات,كبيرة,2,106,46,60,826,773,53
2023,1,منطقة الباحة,الخدمات,متناهية الصغر,46,8,4,4,99,99,0
2023,1,منطقة الباحة,الخدمات,متوسطة,2,46,30,16,110,109,1
2023,1,منطقة الجوف,الخدمات,صغيرة,24,52,31,21,244,241,3
2023,1,منطقة الجوف,الخدمات,كبيرة,1,91,40,51,277,277,0
2023,1,منطقة الجوف,الخدمات,متناهية الصغر,186,24,11,13,421,412,9
2023,1,منطقة الجوف,الخدمات,متوسطة,5,110,35,75,194,194,0
2023,1,منطقة الحدود الشمالية,الخدمات,صغيرة,9,40,19,21,103,103,0
2023,1,منطقة الحدود الشمالية,الخدمات,كبيرة,1,292,164,128,817,535,282
2023,1,منطقة الحدود الشمالية,الخدمات,متناهية الصغر,77,10,5,5,195,194,1
2023,1,منطقة الحدود الشمالية,الخدمات,متوسطة,2,57,43,14,134,134,0
2023,1,منطقة الرياض,الخدمات,صغيرة,1351,4154,1931,2223,18747,18353,394
2023,1,منطقة الرياض,الخدمات,كبيرة,197,37757,21880,15877,158206,146547,11659
2023,1,منطقة الرياض,الخدمات,متناهية الصغر,3484,1019,494,525,7368,7255,113
2023,1,منطقة الرياض,الخدمات,متوسطة,476,9020,4477,4543,44093,42452,1641
2023,1,منطقة القصيم,الخدمات,صغيرة,194,485,283,202,2821,2791,30
2023,1,منطقة القصيم,الخدمات,كبيرة,41,1710,753,957,17252,16939,313
2023,1,منطقة القصيم,الخدمات,متناهية الصغر,1052,151,88,63,2615,2597,18
2023,1,منطقة القصيم,الخدمات,متوسطة,133,1581,881,700,14170,14015,155
2023,1,منطقة المدينة المنورة,الخدمات,صغيرة,146,396,231,165,1792,1752,40
2023,1,منطقة المدينة المنورة,الخدمات,كبيرة,4,262,79,183,1298,1250,48
2023,1,منطقة المدينة المنورة,الخدمات,متناهية الصغر,687,148,87,61,1601,1579,22
2023,1,منطقة المدينة المنورة,الخدمات,متوسطة,35,820,525,295,3270,3160,110
2023,1,منطقة تبوك,الخدمات,صغيرة,34,83,47,36,348,348,0
2023,1,منطقة تبوك,الخدمات,كبيرة,1,48,15,33,224,223,1
2023,1,منطقة تبوك,الخدمات,متناهية الصغر,292,37,12,25,672,668,4
2023,1,منطقة تبوك,الخدمات,متوسطة,10,195,96,99,843,840,3
2023,1,منطقة جازان,الخدمات,صغيرة,33,121,57,64,340,339,1
2023,1,منطقة جازان,الخدمات,متناهية الصغر,304,34,18,16,773,770,3
2023,1,منطقة جازان,الخدمات,متوسطة,5,53,47,6,371,348,23
2023,1,منطقة حائل,الخدمات,صغيرة,37,79,43,36,461,459,2
2023,1,منطقة حائل,الخدمات,كبيرة,1,842,597,245,917,829,88
2023,1,منطقة حائل,الخدمات,متناهية الصغر,302,37,18,19,698,689,9
2023,1,منطقة حائل,الخدمات,متوسطة,16,309,145,164,1386,1366,20
2023,1,منطقة عسير,الخدمات,صغيرة,64,208,102,106,739,729,10
2023,1,منطقة عسير,الخدمات,كبيرة,7,1599,1337,262,5136,5039,97
2023,1,منطقة عسير,الخدمات,متناهية الصغر,471,78,45,33,1088,1080,8
2023,1,منطقة عسير,الخدمات,متوسطة,11,266,146,120,1071,1065,6
2023,1,منطقة مكة المكرمة,الخدمات,صغيرة,845,2734,1288,1446,11078,10756,322
2023,1,منطقة مكة المكرمة,الخدمات,كبيرة,62,11755,7398,4357,45585,44339,1246
2023,1,منطقة مكة المكرمة,الخدمات,متناهية الصغر,2783,747,365,382,6474,6349,125
2023,1,منطقة مكة المكرمة,الخدمات,متوسطة,231,5110,2735,2375,20462,19613,849
2023,1,منطقة نجران,الخدمات,صغيرة,40,107,49,58,541,536,5
2023,1,منطقة نجران,الخدمات,كبيرة,8,1276,724,552,6842,6784,58
2023,1,منطقة نجران,الخدمات,متناهية الصغر,167,18,9,9,400,391,9
2023,1,منطقة نجران,الخدمات,متوسطة,16,323,166,157,1285,1283,2
2023,1,المنطقة الشرقية,أنشطة النشر,صغيرة,19,123,61,62,160,157,3
2023,1,المنطقة الشرقية,أنشطة النشر,متناهية الصغر,65,37,13,24,117,116,1
2023,1,المنطقة الشرقية,أنشطة النشر,متوسطة,2,128,107,21,141,141,0
2023,1,منطقة الباحة,أنشطة النشر,صغيرة,1,4,2,2,13,13,0
2023,1,منطقة الباحة,أنشطة النشر,متناهية الصغر,6,2,2,0,11,11,0
2023,1,منطقة الجوف,أنشطة النشر,متناهية الصغر,2,0,0,0,4,4,0
2023,1,منطقة الحدود الشمالية,أنشطة النشر,متناهية الصغر,2,0,0,0,3,3,0
2023,1,منطقة الرياض,أنشطة النشر,صغيرة,76,593,280,313,579,564,15
2023,1,منطقة الرياض,أنشطة النشر,كبيرة,3,1492,511,981,1205,1092,113
2023,1,منطقة الرياض,أنشطة النشر,متناهية الصغر,201,166,64,102,279,269,10
2023,1,منطقة الرياض,أنشطة النشر,متوسطة,8,600,260,340,304,294,10
2023,1,منطقة القصيم,أنشطة النشر,صغيرة,1,0,0,0,35,35,0
2023,1,منطقة القصيم,أنشطة النشر,متناهية الصغر,12,1,1,0,23,23,0
2023,1,منطقة المدينة المنورة,أنشطة النشر,صغيرة,3,10,6,4,10,10,0
2023,1,منطقة المدينة المنورة,أنشطة النشر,متناهية الصغر,14,5,1,4,28,28,0
2023,1,منطقة تبوك,أنشطة النشر,متناهية الصغر,3,1,1,0,7,7,0
2023,1,منطقة جازان,أنشطة النشر,متناهية الصغر,4,0,0,0,8,8,0
2023,1,منطقة حائل,أنشطة النشر,صغيرة,1,3,1,2,8,8,0
2023,1,منطقة حائل,أنشطة النشر,متناهية الصغر,24,3,0,3,77,77,0
2023,1,منطقة عسير,أنشطة النشر,صغيرة,1,5,4,1,6,6,0
2023,1,منطقة عسير,أنشطة النشر,متناهية الصغر,10,4,4,0,19,19,0
2023,1,منطقة عسير,أنشطة النشر,متوسطة,1,16,9,7,44,44,0
2023,1,منطقة مكة المكرمة,أنشطة النشر,صغيرة,17,96,39,57,138,135,3
2023,1,منطقة مكة المكرمة,أنشطة النشر,متناهية الصغر,102,56,20,36,162,159,3
2023,1,منطقة مكة المكرمة,أنشطة النشر,متوسطة,4,91,72,19,197,194,3
2023,1,منطقة نجران,أنشطة النشر,متناهية الصغر,2,0,0,0,3,3,0
2023,1,منطقة نجران,أنشطة النشر,متوسطة,1,0,0,0,60,60,0
2023,1,المنطقة الشرقية,أنشطة المنظمات ذات العضوية,صغيرة,14,100,35,65,65,61,4
2023,1,المنطقة الشرقية,أنشطة المنظمات ذات العضوية,متناهية الصغر,66,62,37,25,83,80,3
2023,1,المنطقة الشرقية,أنشطة المنظمات ذات العضوية,متوسطة,1,86,43,43,74,70,4
2023,1,منطقة الباحة,أنشطة المنظمات ذات العضوية,متناهية الصغر,15,22,18,4,8,8,0
2023,1,منطقة الجوف,أنشطة المنظمات ذات العضوية,صغيرة,3,32,25,7,10,10,0
2023,1,منطقة الجوف,أنشطة المنظمات ذات العضوية,متناهية الصغر,21,23,16,7,27,27,0
2023,1,منطقة الحدود الشمالية,أنشطة المنظمات ذات العضوية,صغيرة,1,2,2,0,13,13,0
2023,1,منطقة الحدود الشمالية,أنشطة المنظمات ذات العضوية,متناهية الصغر,6,9,8,1,2,2,0
2023,1,منطقة الرياض,أنشطة المنظمات ذات العضوية,صغيرة,73,425,215,210,504,481,23
2023,1,منطقة الرياض,أنشطة المنظمات ذات العضوية,متناهية الصغر,2178,298,168,130,5001,4932,69
2023,1,منطقة الرياض,أنشطة المنظمات ذات العضوية,متوسطة,1,118,37,81,71,33,38
2023,1,منطقة القصيم,أنشطة المنظمات ذات العضوية,صغيرة,11,72,31,41,43,42,1
2023,1,منطقة القصيم,أنشطة المنظمات ذات العضوية,متناهية الصغر,72,60,46,14,111,111,0
2023,1,منطقة المدينة المنورة,أنشطة المنظمات ذات العضوية,صغيرة,8,62,47,15,44,44,0
2023,1,منطقة المدينة المنورة,أنشطة المنظمات ذات العضوية,متناهية الصغر,77,18,13,5,139,135,4
2023,1,منطقة تبوك,أنشطة المنظمات ذات العضوية,صغيرة,4,54,15,39,7,6,1
2023,1,منطقة تبوك,أنشطة المنظمات ذات العضوية,متناهية الصغر,15,13,8,5,19,18,1
2023,1,منطقة تبوك,أنشطة المنظمات ذات العضوية,متوسطة,1,67,16,51,0,0,0
2023,1,منطقة جازان,أنشطة المنظمات ذات العضوية,صغيرة,8,86,34,52,32,30,2
2023,1,منطقة جازان,أنشطة المنظمات ذات العضوية,متناهية الصغر,128,45,23,22,231,227,4
2023,1,منطقة جازان,أنشطة المنظمات ذات العضوية,متوسطة,2,96,38,58,12,12,0
2023,1,منطقة حائل,أنشطة المنظمات ذات العضوية,صغيرة,5,35,22,13,15,15,0
2023,1,منطقة حائل,أنشطة المنظمات ذات العضوية,متناهية الصغر,28,32,11,21,37,36,1
2023,1,منطقة عسير,أنشطة المنظمات ذات العضوية,صغيرة,4,17,5,12,19,17,2
2023,1,منطقة عسير,أنشطة المنظمات ذات العضوية,متناهية الصغر,34,28,20,8,33,30,3
2023,1,منطقة عسير,أنشطة المنظمات ذات العضوية,متوسطة,1,49,14,35,26,25,1
2023,1,منطقة مكة المكرمة,أنشطة المنظمات ذات العضوية,صغيرة,23,161,108,53,159,159,0
2023,1,منطقة مكة المكرمة,أنشطة المنظمات ذات العضوية,كبيرة,1,444,241,203,78,78,0
2023,1,منطقة مكة المكرمة,أنشطة المنظمات ذات العضوية,متناهية الصغر,246,151,101,50,392,378,14
2023,1,منطقة مكة المكرمة,أنشطة المنظمات ذات العضوية,متوسطة,4,302,156,146,88,74,14
2023,1,منطقة نجران,أنشطة المنظمات ذات العضوية,صغيرة,2,51,44,7,4,4,0
2023,1,منطقة نجران,أنشطة المنظمات ذات العضوية,متناهية الصغر,30,21,15,6,43,42,1
2023,1,المنطقة الشرقية,أنشطة المكتبات والمحفوظات والمتاحف والأنشطة الثقافية الأخرى,صغيرة,6,24,15,9,53,52,1
2023,1,المنطقة الشرقية,أنشطة المكتبات والمحفوظات والمتاحف والأنشطة الثقافية الأخرى,متناهية الصغر,24,9,4,5,38,38,0
2023,1,منطقة الباحة,أنشطة المكتبات والمحفوظات والمتاحف والأنشطة الثقافية الأخرى,متناهية الصغر,2,0,0,0,5,5,0
2023,1,منطقة الحدود الشمالية,أنشطة المكتبات والمحفوظات والمتاحف والأنشطة الثقافية الأخرى,متناهية الصغر,2,0,0,0,4,4,0
2023,1,منطقة الرياض,أنشطة المكتبات والمحفوظات والمتاحف والأنشطة الثقافية الأخرى,صغيرة,1,3,3,0,8,8,0
2023,1,منطقة الرياض,أنشطة المكتبات والمحفوظات والمتاحف والأنشطة الثقافية الأخرى,متناهية الصغر,20,9,5,4,42,41,1
2023,1,منطقة القصيم,أنشطة المكتبات والمحفوظات والمتاحف والأنشطة الثقافية الأخرى,صغيرة,1,2,2,0,4,4,0
2023,1,منطقة القصيم,أنشطة المكتبات والمحفوظات والمتاحف والأنشطة الثقافية الأخرى,متناهية الصغر,4,3,2,1,10,10,0
2023,1,منطقة المدينة المنورة,أنشطة المكتبات والمحفوظات والمتاحف والأنشطة الثقافية الأخرى,صغيرة,1,1,1,0,7,7,0
2023,1,منطقة المدينة المنورة,أنشطة المكتبات والمحفوظات والمتاحف والأنشطة الثقافية الأخرى,متناهية الصغر,26,11,7,4,44,44,0
2023,1,منطقة تبوك,أنشطة المكتبات والمحفوظات والمتاحف والأنشطة الثقافية الأخرى,متناهية الصغر,6,3,3,0,9,9,0
2023,1,منطقة جازان,أنشطة المكتبات والمحفوظات والمتاحف والأنشطة الثقافية الأخرى,متناهية الصغر,11,0,0,0,26,26,0
2023,1,منطقة حائل,أنشطة المكتبات والمحفوظات والمتاحف والأنشطة الثقافية الأخرى,متناهية الصغر,4,0,0,0,4,4,0
2023,1,منطقة عسير,أنشطة المكتبات والمحفوظات والمتاحف والأنشطة الثقافية الأخرى,متناهية الصغر,12,5,4,1,19,19,0
2023,1,منطقة مكة المكرمة,أنشطة المكتبات والمحفوظات والمتاحف والأنشطة الثقافية الأخرى,صغيرة,4,3,2,1,23,23,0
2023,1,منطقة مكة المكرمة,أنشطة المكتبات والمحفوظات والمتاحف والأنشطة الثقافية الأخرى,متناهية الصغر,66,20,14,6,108,107,1
2023,1,منطقة مكة المكرمة,أنشطة المكتبات والمحفوظات والمتاحف والأنشطة الثقافية الأخرى,متوسطة,1,64,37,27,96,96,0
2023,1,منطقة نجران,أنشطة المكتبات والمحفوظات والمتاحف والأنشطة الثقافية الأخرى,متناهية الصغر,6,0,0,0,13,13,0
2023,1,المنطقة الشرقية,أنشطة المكاتب,صغيرة,40,261,143,118,335,320,15
2023,1,المنطقة الشرقية,أنشطة المكاتب,متناهية الصغر,110,97,53,44,130,123,7
2023,1,المنطقة الشرقية,أنشطة المكاتب,متوسطة,7,281,178,103,302,291,11
2023,1,منطقة الباحة,أنشطة المكاتب,متناهية الصغر,2,1,0,1,3,3,0
2023,1,منطقة الجوف,أنشطة المكاتب,متناهية الصغر,1,1,0,1,1,1,0
2023,1,منطقة الجوف,أنشطة المكاتب,متوسطة,1,18,1,17,32,29,3
2023,1,منطقة الحدود الشمالية,أنشطة المكاتب,متناهية الصغر,3,0,0,0,8,8,0
2023,1,منطقة الرياض,أنشطة المكاتب,صغيرة,250,1890,982,908,1823,1640,183
2023,1,منطقة الرياض,أنشطة المكاتب,كبيرة,11,12933,7461,5472,3710,3515,195
2023,1,منطقة الرياض,أنشطة المكاتب,متناهية الصغر,705,660,322,338,954,895,59
2023,1,منطقة الرياض,أنشطة المكاتب,متوسطة,35,1945,1133,812,1798,1677,121
2023,1,منطقة القصيم,أنشطة المكاتب,صغيرة,3,23,10,13,10,10,0
2023,1,منطقة القصيم,أنشطة المكاتب,متناهية الصغر,15,10,6,4,22,20,2
2023,1,منطقة القصيم,أنشطة المكاتب,متوسطة,1,74,67,7,108,107,1
2023,1,منطقة المدينة المنورة,أنشطة المكاتب,صغيرة,4,47,26,21,8,8,0
2023,1,منطقة المدينة المنورة,أنشطة المكاتب,متناهية الصغر,31,21,9,12,46,45,1
2023,1,منطقة تبوك,أنشطة المكاتب,متناهية الصغر,2,1,1,0,1,1,0
2023,1,منطقة جازان,أنشطة المكاتب,متناهية الصغر,5,6,0,6,10,9,1
2023,1,منطقة حائل,أنشطة المكاتب,متناهية الصغر,5,2,1,1,11,11,0
2023,1,منطقة عسير,أنشطة المكاتب,متناهية الصغر,17,15,9,6,22,21,1
2023,1,منطقة مكة المكرمة,أنشطة المكاتب,صغيرة,79,454,234,220,640,597,43
2023,1,منطقة مكة المكرمة,أنشطة المكاتب,متناهية الصغر,247,200,100,100,348,328,20
2023,1,منطقة مكة المكرمة,أنشطة المكاتب,متوسطة,4,144,99,45,191,186,5
2023,1,منطقة نجران,أنشطة المكاتب,متناهية الصغر,4,0,0,0,12,12,0
2023,1,المنطقة الشرقية,الأنشطه المعماريه والهندسيه,صغيرة,266,1687,977,710,2386,2345,41
2023,1,المنطقة الشرقية,الأنشطه المعماريه والهندسيه,كبيرة,23,5008,4020,988,6431,6406,25
2023,1,المنطقة الشرقية,الأنشطه المعماريه والهندسيه,متناهية الصغر,466,368,219,149,823,813,10
2023,1,المنطقة الشرقية,الأنشطه المعماريه والهندسيه,متوسطة,70,2962,2211,751,3924,3907,17
2023,1,منطقة الباحة,الأنشطه المعماريه والهندسيه,صغيرة,18,69,41,28,134,133,1
2023,1,منطقة الباحة,الأنشطه المعماريه والهندسيه,متناهية الصغر,96,16,7,9,203,202,1
2023,1,منطقة الجوف,الأنشطه المعماريه والهندسيه,صغيرة,13,46,30,16,138,137,1
2023,1,منطقة الجوف,الأنشطه المعماريه والهندسيه,متناهية الصغر,104,36,22,14,214,212,2
2023,1,منطقة الحدود الشمالية,الأنشطه المعماريه والهندسيه,صغيرة,8,34,21,13,39,39,0
2023,1,منطقة الحدود الشمالية,الأنشطه المعماريه والهندسيه,متناهية الصغر,53,18,11,7,108,107,1
2023,1,منطقة الرياض,الأنشطه المعماريه والهندسيه,صغيرة,499,2911,1666,1245,4387,4288,99
2023,1,منطقة الرياض,الأنشطه المعماريه والهندسيه,كبيرة,28,6421,4369,2052,8696,8564,132
2023,1,منطقة الرياض,الأنشطه المعماريه والهندسيه,متناهية الصغر,3362,923,489,434,7433,7369,64
2023,1,منطقة الرياض,الأنشطه المعماريه والهندسيه,متوسطة,113,5675,3510,2165,7401,7179,222
2023,1,منطقة القصيم,الأنشطه المعماريه والهندسيه,صغيرة,41,206,131,75,334,332,2
2023,1,منطقة القصيم,الأنشطه المعماريه والهندسيه,متناهية الصغر,168,74,56,18,316,316,0
2023,1,منطقة القصيم,الأنشطه المعماريه والهندسيه,متوسطة,5,206,133,73,224,223,1
2023,1,منطقة المدينة المنورة,الأنشطه المعماريه والهندسيه,صغيرة,72,313,178,135,622,616,6
2023,1,منطقة المدينة المنورة,الأنشطه المعماريه والهندسيه,كبيرة,1,153,82,71,179,178,1
2023,1,منطقة المدينة المنورة,الأنشطه المعماريه والهندسيه,متناهية الصغر,147,67,28,39,285,285,0
2023,1,منطقة المدينة المنورة,الأنشطه المعماريه والهندسيه,متوسطة,7,376,267,109,443,443,0
2023,1,منطقة تبوك,الأنشطه المعماريه والهندسيه,صغيرة,21,100,77,23,171,171,0
2023,1,منطقة تبوك,الأنشطه المعماريه والهندسيه,متناهية الصغر,84,43,20,23,150,146,4
2023,1,منطقة تبوك,الأنشطه المعماريه والهندسيه,متوسطة,1,44,19,25,31,31,0
2023,1,منطقة جازان,الأنشطه المعماريه والهندسيه,صغيرة,22,132,75,57,184,183,1
2023,1,منطقة جازان,الأنشطه المعماريه والهندسيه,متناهية الصغر,151,82,46,36,242,234,8
2023,1,منطقة جازان,الأنشطه المعماريه والهندسيه,متوسطة,1,30,13,17,33,33,0
2023,1,منطقة حائل,الأنشطه المعماريه والهندسيه,صغيرة,19,108,48,60,212,207,5
2023,1,منطقة حائل,الأنشطه المعماريه والهندسيه,متناهية الصغر,165,25,20,5,386,386,0
2023,1,منطقة حائل,الأنشطه المعماريه والهندسيه,متوسطة,1,40,38,2,57,57,0
2023,1,منطقة عسير,الأنشطه المعماريه والهندسيه,صغيرة,58,255,177,78,418,416,2
2023,1,منطقة عسير,الأنشطه المعماريه والهندسيه,متناهية الصغر,258,144,88,56,482,480,2
2023,1,منطقة عسير,الأنشطه المعماريه والهندسيه,متوسطة,1,25,23,2,40,39,1
2023,1,منطقة مكة المكرمة,الأنشطه المعماريه والهندسيه,صغيرة,396,1892,1091,801,3393,3339,54
2023,1,منطقة مكة المكرمة,الأنشطه المعماريه والهندسيه,كبيرة,7,1198,837,361,1760,1746,14
2023,1,منطقة مكة المكرمة,الأنشطه المعماريه والهندسيه,متناهية الصغر,962,594,332,262,1680,1645,35
2023,1,منطقة مكة المكرمة,الأنشطه المعماريه والهندسيه,متوسطة,27,1078,665,413,1564,1550,14
2023,1,منطقة نجران,الأنشطه المعماريه والهندسيه,صغيرة,15,68,43,25,149,149,0
2023,1,منطقة نجران,الأنشطه المعماريه والهندسيه,متناهية الصغر,155,29,14,15,352,350,2
2023,1,المنطقة الشرقية,الخدمات,صغيرة,7,25,10,15,78,77,1
2023,1,المنطقة الشرقية,الخدمات,متناهية الصغر,3,2,2,0,3,3,0
2023,1,المنطقة الشرقية,الخدمات,متوسطة,1,29,28,1,59,59,0
2023,1,منطقة الرياض,الخدمات,صغيرة,2,28,24,4,22,22,0
2023,1,منطقة الرياض,الخدمات,كبيرة,1,1381,1112,269,14791,14462,329
2023,1,منطقة الرياض,الخدمات,متناهية الصغر,5,3,1,2,11,11,0
2023,1,منطقة المدينة المنورة,الخدمات,متناهية الصغر,1,0,0,0,2,2,0
2023,1,منطقة جازان,الخدمات,متناهية الصغر,1,0,0,0,4,4,0
2023,1,منطقة مكة المكرمة,الخدمات,صغيرة,2,7,5,2,38,38,0
2023,1,منطقة مكة المكرمة,الخدمات,متناهية الصغر,1,1,0,1,2,2,0
2023,1,منطقة نجران,الخدمات,متناهية الصغر,1,1,0,1,1,1,0
2023,1,المنطقة الشرقية,أنشطة العمل الاجتماعي، دون إقامة,صغيرة,195,2185,384,1801,458,384,74
2023,1,المنطقة الشرقية,أنشطة العمل الاجتماعي، دون إقامة,كبيرة,2,317,141,176,405,293,112
2023,1,المنطقة الشرقية,أنشطة العمل الاجتماعي، دون إقامة,متناهية الصغر,198,385,59,326,127,99,28
2023,1,المنطقة الشرقية,أنشطة العمل الاجتماعي، دون إقامة,متوسطة,20,1497,372,1125,441,296,145
2023,1,منطقة الباحة,أنشطة العمل الاجتماعي، دون إقامة,صغيرة,31,284,151,133,97,88,9
2023,1,منطقة الباحة,أنشطة العمل الاجتماعي، دون إقامة,متناهية الصغر,43,74,67,7,31,31,0
2023,1,منطقة الباحة,أنشطة العمل الاجتماعي، دون إقامة,متوسطة,1,50,11,39,0,0,0
2023,1,منطقة الجوف,أنشطة العمل الاجتماعي، دون إقامة,صغيرة,24,222,116,106,100,96,4
2023,1,منطقة الجوف,أنشطة العمل الاجتماعي، دون إقامة,متناهية الصغر,22,53,26,27,7,7,0
2023,1,منطقة الحدود الشمالية,أنشطة العمل الاجتماعي، دون إقامة,صغيرة,13,90,43,47,31,30,1
2023,1,منطقة الحدود الشمالية,أنشطة العمل الاجتماعي، دون إقامة,متناهية الصغر,25,50,27,23,16,15,1
2023,1,منطقة الرياض,أنشطة العمل الاجتماعي، دون إقامة,صغيرة,312,3255,844,2411,1617,1365,252
2023,1,منطقة الرياض,أنشطة العمل الاجتماعي، دون إقامة,كبيرة,7,1496,779,717,932,842,90
2023,1,منطقة الرياض,أنشطة العمل الاجتماعي، دون إقامة,متناهية الصغر,429,602,246,356,445,396,49
2023,1,منطقة الرياض,أنشطة العمل الاجتماعي، دون إقامة,متوسطة,35,2363,1018,1345,1000,834,166
2023,1,منطقة القصيم,أنشطة العمل الاجتماعي، دون إقامة,صغيرة,80,839,399,440,343,321,22
2023,1,منطقة القصيم,أنشطة العمل الاجتماعي، دون إقامة,متناهية الصغر,107,169,98,71,93,91,2
2023,1,منطقة القصيم,أنشطة العمل الاجتماعي، دون إقامة,متوسطة,5,396,123,273,276,206,70
2023,1,منطقة المدينة المنورة,أنشطة العمل الاجتماعي، دون إقامة,صغيرة,75,797,359,438,242,215,27
2023,1,منطقة المدينة المنورة,أنشطة العمل الاجتماعي، دون إقامة,متناهية الصغر,165,347,178,169,106,89,17
2023,1,منطقة المدينة المنورة,أنشطة العمل الاجتماعي، دون إقامة,متوسطة,13,683,288,395,296,212,84
2023,1,منطقة تبوك,أنشطة العمل الاجتماعي، دون إقامة,صغيرة,15,153,71,82,40,40,0
2023,1,منطقة تبوك,أنشطة العمل الاجتماعي، دون إقامة,متناهية الصغر,39,90,53,37,16,15,1
2023,1,منطقة تبوك,أنشطة العمل الاجتماعي، دون إقامة,متوسطة,1,62,1,61,14,8,6
2023,1,منطقة جازان,أنشطة العمل الاجتماعي، دون إقامة,صغيرة,30,293,148,145,90,86,4
2023,1,منطقة جازان,أنشطة العمل الاجتماعي، دون إقامة,متناهية الصغر,67,128,80,48,42,41,1
2023,1,منطقة جازان,أنشطة العمل الاجتماعي، دون إقامة,متوسطة,2,112,33,79,18,12,6
2023,1,منطقة حائل,أنشطة العمل الاجتماعي، دون إقامة,صغيرة,18,239,107,132,32,30,2
2023,1,منطقة حائل,أنشطة العمل الاجتماعي، دون إقامة,متناهية الصغر,69,103,66,37,62,62,0
2023,1,منطقة حائل,أنشطة العمل الاجتماعي، دون إقامة,متوسطة,1,49,2,47,4,2,2
2023,1,منطقة عسير,أنشطة العمل الاجتماعي، دون إقامة,صغيرة,73,616,312,304,306,292,14
2023,1,منطقة عسير,أنشطة العمل الاجتماعي، دون إقامة,متناهية الصغر,117,246,180,66,57,57,0
2023,1,منطقة عسير,أنشطة العمل الاجتماعي، دون إقامة,متوسطة,4,196,46,150,95,67,28
2023,1,منطقة مكة المكرمة,أنشطة العمل الاجتماعي، دون إقامة,صغيرة,269,2710,887,1823,1163,896,267
2023,1,منطقة مكة المكرمة,أنشطة العمل الاجتماعي، دون إقامة,متناهية الصغر,420,691,259,432,347,282,65
2023,1,منطقة مكة المكرمة,أنشطة العمل الاجتماعي، دون إقامة,متوسطة,22,1271,622,649,753,697,56
2023,1,منطقة نجران,أنشطة العمل الاجتماعي، دون إقامة,صغيرة,12,77,29,48,77,73,4
2023,1,منطقة نجران,أنشطة العمل الاجتماعي، دون إقامة,متناهية الصغر,35,60,33,27,38,37,1
2023,1,المنطقة الشرقية,الخدمات,صغيرة,73,568,346,222,733,715,18
2023,1,المنطقة الشرقية,الخدمات,كبيرة,2,891,534,357,156,142,14
2023,1,المنطقة الشرقية,الخدمات,متناهية الصغر,181,121,77,44,280,275,5
2023,1,المنطقة الشرقية,الخدمات,متوسطة,19,1151,735,416,779,763,16
2023,1,منطقة الباحة,الخدمات,متناهية الصغر,6,3,3,0,8,8,0
2023,1,منطقة الجوف,الخدمات,صغيرة,1,6,6,0,0,0,0
2023,1,منطقة الجوف,الخدمات,متناهية الصغر,8,2,2,0,8,8,0
2023,1,منطقة الحدود الشمالية,الخدمات,متناهية الصغر,4,0,0,0,12,12,0
2023,1,منطقة الحدود الشمالية,الخدمات,متوسطة,1,0,0,0,55,55,0
2023,1,منطقة الرياض,الخدمات,صغيرة,200,1752,1068,684,1326,1280,46
2023,1,منطقة الرياض,الخدمات,كبيرة,13,21217,17132,4085,1357,1334,23
2023,1,منطقة الرياض,الخدمات,متناهية الصغر,466,469,309,160,621,594,27
2023,1,منطقة الرياض,الخدمات,متوسطة,40,2710,1827,883,1567,1461,106
2023,1,منطقة القصيم,الخدمات,صغيرة,6,23,20,3,59,59,0
2023,1,منطقة القصيم,الخدمات,متناهية الصغر,26,6,3,3,46,46,0
2023,1,منطقة المدينة المنورة,الخدمات,صغيرة,4,35,34,1,22,22,0
2023,1,منطقة المدينة المنورة,الخدمات,كبيرة,1,208,174,34,89,88,1
2023,1,منطقة المدينة المنورة,الخدمات,متناهية الصغر,42,33,17,16,65,64,1
2023,1,منطقة تبوك,الخدمات,متناهية الصغر,14,2,2,0,25,25,0
2023,1,منطقة جازان,الخدمات,متناهية الصغر,16,1,0,1,35,35,0
2023,1,منطقة حائل,الخدمات,متناهية الصغر,19,4,4,0,48,48,0
2023,1,منطقة عسير,الخدمات,صغيرة,3,24,10,14,21,21,0
2023,1,منطقة عسير,الخدمات,متناهية الصغر,25,8,4,4,36,35,1
2023,1,منطقة مكة المكرمة,الخدمات,صغيرة,104,620,345,275,895,852,43
2023,1,منطقة مكة المكرمة,الخدمات,كبيرة,2,2865,2342,523,257,254,3
2023,1,منطقة مكة المكرمة,الخدمات,متناهية الصغر,346,202,136,66,596,576,20
2023,1,منطقة مكة المكرمة,الخدمات,متوسطة,19,1031,714,317,625,614,11
2023,1,منطقة نجران,الخدمات,صغيرة,1,2,0,2,5,5,0
2023,1,منطقة نجران,الخدمات,متناهية الصغر,11,3,1,2,22,22,0
2023,1,المنطقة الشرقية,الخدمات,صغيرة,722,1446,324,1122,5524,3536,1988
2023,1,المنطقة الشرقية,الخدمات,كبيرة,4,287,118,169,2243,2243,0
2023,1,المنطقة الشرقية,الخدمات,متناهية الصغر,6669,1312,451,861,14618,13330,1288
2023,1,المنطقة الشرقية,الخدمات,متوسطة,12,250,92,158,950,915,35
2023,1,منطقة الباحة,الخدمات,صغيرة,9,10,9,1,49,49,0
2023,1,منطقة الباحة,الخدمات,متناهية الصغر,507,70,33,37,1014,948,66
2023,1,منطقة الجوف,الخدمات,صغيرة,40,65,38,27,322,290,32
2023,1,منطقة الجوف,الخدمات,متناهية الصغر,836,85,46,39,1736,1624,112
2023,1,منطقة الحدود الشمالية,الخدمات,صغيرة,21,28,8,20,147,98,49
2023,1,منطقة الحدود الشمالية,الخدمات,متناهية الصغر,639,63,26,37,1465,1366,99
2023,1,منطقة الرياض,الخدمات,صغيرة,1458,3445,768,2677,12343,7995,4348
2023,1,منطقة الرياض,الخدمات,كبيرة,3,1079,545,534,1483,1045,438
2023,1,منطقة الرياض,الخدمات,متناهية الصغر,10578,2159,710,1449,23161,20587,2574
2023,1,منطقة الرياض,الخدمات,متوسطة,34,742,123,619,2169,1519,650
2023,1,منطقة القصيم,الخدمات,صغيرة,132,236,50,186,1065,652,413
2023,1,منطقة القصيم,الخدمات,متناهية الصغر,2270,245,98,147,4935,4573,362
2023,1,منطقة القصيم,الخدمات,متوسطة,4,69,34,35,260,202,58
2023,1,منطقة المدينة المنورة,الخدمات,صغيرة,156,324,71,253,1226,765,461
2023,1,منطقة المدينة المنورة,الخدمات,متناهية الصغر,2998,351,161,190,6121,5706,415
2023,1,منطقة المدينة المنورة,الخدمات,متوسطة,1,41,4,37,110,5,105
2023,1,منطقة تبوك,الخدمات,صغيرة,42,75,15,60,364,282,82
2023,1,منطقة تبوك,الخدمات,متناهية الصغر,1529,169,72,97,3177,3010,167
2023,1,منطقة تبوك,الخدمات,متوسطة,1,15,4,11,64,64,0
2023,1,منطقة جازان,الخدمات,صغيرة,39,101,14,87,295,164,131
2023,1,منطقة جازان,الخدمات,متناهية الصغر,2101,170,89,81,4498,4286,212
2023,1,منطقة حائل,الخدمات,صغيرة,55,118,30,88,454,271,183
2023,1,منطقة حائل,الخدمات,متناهية الصغر,1230,128,46,82,2694,2502,192
2023,1,منطقة حائل,الخدمات,متوسطة,1,36,1,35,57,7,50
2023,1,منطقة عسير,الخدمات,صغيرة,109,173,69,104,788,633,155
2023,1,منطقة عسير,الخدمات,متناهية الصغر,3032,373,161,212,6255,5905,350
2023,1,منطقة مكة المكرمة,الخدمات,صغيرة,743,1770,403,1367,6233,3745,2488
2023,1,منطقة مكة المكرمة,الخدمات,متناهية الصغر,9360,1524,582,942,20044,18180,1864
2023,1,منطقة مكة المكرمة,الخدمات,متوسطة,18,394,48,346,1029,291,738
2023,1,منطقة نجران,الخدمات,صغيرة,23,40,13,27,170,137,33
2023,1,منطقة نجران,الخدمات,متناهية الصغر,935,83,21,62,2051,1900,151
2023,1,المنطقة الشرقية,الأنشطه المعماريه والهندسيه,صغيرة,1974,5030,2513,2517,24273,24182,91
2023,1,المنطقة الشرقية,الأنشطه المعماريه والهندسيه,كبيرة,90,17436,14245,3191,69645,69482,163
2023,1,المنطقة الشرقية,الأنشطه المعماريه والهندسيه,متناهية الصغر,7108,1713,826,887,17792,17746,46
2023,1,المنطقة الشرقية,الأنشطه المعماريه والهندسيه,متوسطة,258,5206,3264,1942,23322,23229,93
2023,1,منطقة الباحة,الأنشطه المعماريه والهندسيه,صغيرة,49,66,45,21,453,453,0
2023,1,منطقة الباحة,الأنشطه المعماريه والهندسيه,متناهية الصغر,544,87,57,30,1257,1256,1
2023,1,منطقة الباحة,الأنشطه المعماريه والهندسيه,متوسطة,4,84,47,37,388,388,0
2023,1,منطقة الجوف,الأنشطه المعماريه والهندسيه,صغيرة,59,100,66,34,648,632,16
2023,1,منطقة الجوف,الأنشطه المعماريه والهندسيه,متناهية الصغر,714,92,61,31,1663,1658,5
2023,1,منطقة الجوف,الأنشطه المعماريه والهندسيه,متوسطة,5,59,39,20,361,360,1
2023,1,منطقة الحدود الشمالية,الأنشطه المعماريه والهندسيه,صغيرة,35,60,31,29,282,280,2
2023,1,منطقة الحدود الشمالية,الأنشطه المعماريه والهندسيه,متناهية الصغر,484,51,33,18,1290,1287,3
2023,1,منطقة الحدود الشمالية,الأنشطه المعماريه والهندسيه,متوسطة,2,38,37,1,232,232,0
2023,1,منطقة الرياض,الأنشطه المعماريه والهندسيه,صغيرة,3160,8581,3683,4898,40640,40306,334
2023,1,منطقة الرياض,الأنشطه المعماريه والهندسيه,كبيرة,158,32977,24533,8444,113815,111903,1912
2023,1,منطقة الرياض,الأنشطه المعماريه والهندسيه,متناهية الصغر,12272,2874,1270,1604,29080,28841,239
2023,1,منطقة الرياض,الأنشطه المعماريه والهندسيه,متوسطة,532,9822,5421,4401,44636,44349,287
2023,1,منطقة القصيم,الأنشطه المعماريه والهندسيه,صغيرة,365,634,341,293,4453,4442,11
2023,1,منطقة القصيم,الأنشطه المعماريه والهندسيه,كبيرة,11,832,566,266,6286,6005,281
2023,1,منطقة القصيم,الأنشطه المعماريه والهندسيه,متناهية الصغر,2906,394,234,160,7176,7149,27
2023,1,منطقة القصيم,الأنشطه المعماريه والهندسيه,متوسطة,47,321,195,126,4658,4658,0
2023,1,منطقة المدينة المنورة,الأنشطه المعماريه والهندسيه,صغيرة,375,733,413,320,3904,3885,19
2023,1,منطقة المدينة المنورة,الأنشطه المعماريه والهندسيه,كبيرة,9,1435,845,590,5401,5264,137
2023,1,منطقة المدينة المنورة,الأنشطه المعماريه والهندسيه,متناهية الصغر,3271,514,284,230,8367,8320,47
2023,1,منطقة المدينة المنورة,الأنشطه المعماريه والهندسيه,متوسطة,22,360,203,157,1556,1548,8
2023,1,منطقة تبوك,الأنشطه المعماريه والهندسيه,صغيرة,83,147,70,77,820,817,3
2023,1,منطقة تبوك,الأنشطه المعماريه والهندسيه,كبيرة,1,97,87,10,702,702,0
2023,1,منطقة تبوك,الأنشطه المعماريه والهندسيه,متناهية الصغر,1423,190,97,93,3511,3504,7
2023,1,منطقة تبوك,الأنشطه المعماريه والهندسيه,متوسطة,3,34,13,21,181,181,0
2023,1,منطقة جازان,الأنشطه المعماريه والهندسيه,صغيرة,98,160,82,78,802,802,0
2023,1,منطقة جازان,الأنشطه المعماريه والهندسيه,متناهية الصغر,2385,268,144,124,6136,6110,26
2023,1,منطقة جازان,الأنشطه المعماريه والهندسيه,متوسطة,2,37,27,10,243,243,0
2023,1,منطقة حائل,الأنشطه المعماريه والهندسيه,صغيرة,101,143,66,77,992,992,0
2023,1,منطقة حائل,الأنشطه المعماريه والهندسيه,كبيرة,2,205,152,53,773,769,4
2023,1,منطقة حائل,الأنشطه المعماريه والهندسيه,متناهية الصغر,1138,130,60,70,2807,2796,11
2023,1,منطقة حائل,الأنشطه المعماريه والهندسيه,متوسطة,9,113,83,30,773,762,11
2023,1,منطقة عسير,الأنشطه المعماريه والهندسيه,صغيرة,311,608,337,271,3020,3004,16
2023,1,منطقة عسير,الأنشطه المعماريه والهندسيه,كبيرة,4,475,155,320,2512,2511,1
2023,1,منطقة عسير,الأنشطه المعماريه والهندسيه,متناهية الصغر,3167,436,220,216,7502,7488,14
2023,1,منطقة عسير,الأنشطه المعماريه والهندسيه,متوسطة,13,288,187,101,889,888,1
2023,1,منطقة مكة المكرمة,الأنشطه المعماريه والهندسيه,صغيرة,1988,4914,2413,2501,22704,22515,189
2023,1,منطقة مكة المكرمة,الأنشطه المعماريه والهندسيه,كبيرة,52,5904,3855,2049,27512,27372,140
2023,1,منطقة مكة المكرمة,الأنشطه المعماريه والهندسيه,متناهية الصغر,11485,2259,1088,1171,27339,27041,298
2023,1,منطقة مكة المكرمة,الأنشطه المعماريه والهندسيه,متوسطة,221,4315,2634,1681,18866,18775,91
2023,1,منطقة نجران,الأنشطه المعماريه والهندسيه,صغيرة,89,129,67,62,981,981,0
2023,1,منطقة نجران,الأنشطه المعماريه والهندسيه,كبيرة,3,305,247,58,3047,3044,3
2023,1,منطقة نجران,الأنشطه المعماريه والهندسيه,متناهية الصغر,1092,126,60,66,2417,2407,10
2023,1,منطقة نجران,الأنشطه المعماريه والهندسيه,متوسطة,9,221,139,82,1008,1008,0
2023,1,المنطقة الشرقية,أنشطة البريد ونقل الرسائل والطرود بواسطة مندوبين,صغيرة,10,60,25,35,97,97,0
2023,1,المنطقة الشرقية,أنشطة البريد ونقل الرسائل والطرود بواسطة مندوبين,كبيرة,1,280,220,60,314,310,4
2023,1,المنطقة الشرقية,أنشطة البريد ونقل الرسائل والطرود بواسطة مندوبين,متناهية الصغر,26,20,8,12,32,32,0
2023,1,المنطقة الشرقية,أنشطة البريد ونقل الرسائل والطرود بواسطة مندوبين,متوسطة,2,44,21,23,260,260,0
2023,1,منطقة الباحة,أنشطة البريد ونقل الرسائل والطرود بواسطة مندوبين,متناهية الصغر,1,1,1,0,0,0,0
2023,1,منطقة الجوف,أنشطة البريد ونقل الرسائل والطرود بواسطة مندوبين,متناهية الصغر,1,0,0,0,4,4,0
2023,1,منطقة الحدود الشمالية,أنشطة البريد ونقل الرسائل والطرود بواسطة مندوبين,متناهية الصغر,1,0,0,0,4,4,0
2023,1,منطقة الرياض,أنشطة البريد ونقل الرسائل والطرود بواسطة مندوبين,صغيرة,103,418,166,252,1054,1028,26
2023,1,منطقة الرياض,أنشطة البريد ونقل الرسائل والطرود بواسطة مندوبين,كبيرة,5,1120,619,501,3473,3446,27
2023,1,منطقة الرياض,أنشطة البريد ونقل الرسائل والطرود بواسطة مندوبين,متناهية الصغر,262,127,63,64,500,486,14
2023,1,منطقة الرياض,أنشطة البريد ونقل الرسائل والطرود بواسطة مندوبين,متوسطة,22,634,351,283,1870,1845,25
2023,1,منطقة القصيم,أنشطة البريد ونقل الرسائل والطرود بواسطة مندوبين,صغيرة,1,1,0,1,6,6,0
2023,1,منطقة القصيم,أنشطة البريد ونقل الرسائل والطرود بواسطة مندوبين,متناهية الصغر,10,2,1,1,16,16,0
2023,1,منطقة المدينة المنورة,أنشطة البريد ونقل الرسائل والطرود بواسطة مندوبين,صغيرة,2,3,2,1,9,9,0
2023,1,منطقة المدينة المنورة,أنشطة البريد ونقل الرسائل والطرود بواسطة مندوبين,متناهية الصغر,15,4,2,2,28,28,0
2023,1,منطقة المدينة المنورة,أنشطة البريد ونقل الرسائل والطرود بواسطة مندوبين,متوسطة,1,80,80,0,127,127,0
2023,1,منطقة تبوك,أنشطة البريد ونقل الرسائل والطرود بواسطة مندوبين,متناهية الصغر,9,1,0,1,24,23,1
2023,1,منطقة جازان,أنشطة البريد ونقل الرسائل والطرود بواسطة مندوبين,صغيرة,1,9,8,1,24,24,0
2023,1,منطقة جازان,أنشطة البريد ونقل الرسائل والطرود بواسطة مندوبين,متناهية الصغر,7,0,0,0,14,14,0
2023,1,منطقة حائل,أنشطة البريد ونقل الرسائل والطرود بواسطة مندوبين,متناهية الصغر,4,0,0,0,12,12,0
2023,1,منطقة عسير,أنشطة البريد ونقل الرسائل والطرود بواسطة مندوبين,صغيرة,3,10,4,6,11,11,0
2023,1,منطقة عسير,أنشطة البريد ونقل الرسائل والطرود بواسطة مندوبين,متناهية الصغر,9,3,2,1,26,26,0
2023,1,منطقة مكة المكرمة,أنشطة البريد ونقل الرسائل والطرود بواسطة مندوبين,صغيرة,30,113,54,59,247,244,3
2023,1,منطقة مكة المكرمة,أنشطة البريد ونقل الرسائل والطرود بواسطة مندوبين,كبيرة,3,1610,1386,224,2391,2391,0
2023,1,منطقة مكة المكرمة,أنشطة البريد ونقل الرسائل والطرود بواسطة مندوبين,متناهية الصغر,99,49,24,25,164,158,6
2023,1,منطقة مكة المكرمة,أنشطة البريد ونقل الرسائل والطرود بواسطة مندوبين,متوسطة,6,111,38,73,324,324,0
2023,1,منطقة نجران,أنشطة البريد ونقل الرسائل والطرود بواسطة مندوبين,متناهية الصغر,3,0,0,0,4,4,0
2023,1,المنطقة الشرقية,البرمجة,صغيرة,3,14,8,6,17,17,0
2023,1,المنطقة الشرقية,البرمجة,متناهية الصغر,11,3,0,3,22,21,1
2023,1,منطقة الجوف,البرمجة,متناهية الصغر,1,0,0,0,1,1,0
2023,1,منطقة الرياض,البرمجة,صغيرة,12,34,18,16,75,73,2
2023,1,منطقة الرياض,البرمجة,متناهية الصغر,60,35,17,18,109,107,2
2023,1,منطقة الرياض,البرمجة,متوسطة,4,197,117,80,209,178,31
2023,1,منطقة القصيم,البرمجة,متناهية الصغر,2,0,0,0,3,3,0
2023,1,منطقة المدينة المنورة,البرمجة,متناهية الصغر,4,1,0,1,9,9,0
2023,1,منطقة تبوك,البرمجة,متناهية الصغر,2,0,0,0,5,5,0
2023,1,منطقة جازان,البرمجة,متناهية الصغر,1,1,0,1,3,3,0
2023,1,منطقة حائل,البرمجة,صغيرة,1,2,1,1,5,5,0
2023,1,منطقة عسير,البرمجة,متناهية الصغر,8,2,2,0,16,16,0
2023,1,منطقة مكة المكرمة,البرمجة,صغيرة,10,71,46,25,86,85,1
2023,1,منطقة مكة المكرمة,البرمجة,متناهية الصغر,23,6,1,5,49,48,1
2023,1,منطقة مكة المكرمة,البرمجة,متوسطة,1,57,29,28,70,70,0
2023,1,منطقة نجران,البرمجة,متناهية الصغر,1,1,1,0,3,3,0
2023,1,المنطقة الشرقية,البرمجة,صغيرة,108,727,365,362,891,869,22
2023,1,المنطقة الشرقية,البرمجة,كبيرة,2,672,605,67,287,287,0
2023,1,المنطقة الشرقية,البرمجة,متناهية الصغر,292,249,118,131,416,408,8
2023,1,المنطقة الشرقية,البرمجة,متوسطة,11,645,320,325,405,395,10
2023,1,منطقة الباحة,البرمجة,متناهية الصغر,4,3,2,1,6,6,0
2023,1,منطقة الجوف,البرمجة,متناهية الصغر,11,9,4,5,25,25,0
2023,1,منطقة الحدود الشمالية,البرمجة,متناهية الصغر,9,2,1,1,15,15,0
2023,1,منطقة الرياض,البرمجة,صغيرة,628,4483,2101,2382,5555,5313,242
2023,1,منطقة الرياض,البرمجة,كبيرة,25,15698,9717,5981,7465,7037,428
2023,1,منطقة الرياض,البرمجة,متناهية الصغر,1471,1191,563,628,2180,2078,102
2023,1,منطقة الرياض,البرمجة,متوسطة,103,5100,3016,2084,4667,4521,146
2023,1,منطقة القصيم,البرمجة,صغيرة,9,53,35,18,75,75,0
2023,1,منطقة القصيم,البرمجة,متناهية الصغر,71,37,16,21,131,131,0
2023,1,منطقة القصيم,البرمجة,متوسطة,1,32,7,25,24,24,0
2023,1,منطقة المدينة المنورة,البرمجة,صغيرة,9,40,13,27,48,48,0
2023,1,منطقة المدينة المنورة,البرمجة,متناهية الصغر,88,41,15,26,151,145,6
2023,1,منطقة المدينة المنورة,البرمجة,متوسطة,1,39,37,2,20,20,0
2023,1,منطقة تبوك,البرمجة,صغيرة,1,5,4,1,13,13,0
2023,1,منطقة تبوك,البرمجة,متناهية الصغر,20,6,2,4,39,39,0
2023,1,منطقة جازان,البرمجة,صغيرة,1,1,1,0,7,7,0
2023,1,منطقة جازان,البرمجة,متناهية الصغر,30,3,2,1,63,63,0
2023,1,منطقة حائل,البرمجة,صغيرة,2,4,1,3,17,17,0
2023,1,منطقة حائل,البرمجة,متناهية الصغر,14,6,3,3,26,26,0
2023,1,منطقة عسير,البرمجة,صغيرة,6,24,14,10,52,51,1
2023,1,منطقة عسير,البرمجة,متناهية الصغر,61,20,9,11,116,114,2
2023,1,منطقة مكة المكرمة,البرمجة,صغيرة,145,702,315,387,1158,1102,56
2023,1,منطقة مكة المكرمة,البرمجة,كبيرة,1,794,767,27,41,38,3
2023,1,منطقة مكة المكرمة,البرمجة,متناهية الصغر,606,376,183,193,967,922,45
2023,1,منطقة مكة المكرمة,البرمجة,متوسطة,13,570,300,270,611,589,22
2023,1,منطقة نجران,البرمجة,متناهية الصغر,11,7,0,7,25,24,1
2023,1,المنطقة الشرقية,أنشطة الأمن والتحقيقات,صغيرة,23,429,392,37,60,56,4
2023,1,المنطقة الشرقية,أنشطة الأمن والتحقيقات,كبيرة,8,5158,4690,468,0,0,0
2023,1,المنطقة الشرقية,أنشطة الأمن والتحقيقات,متناهية الصغر,53,88,78,10,51,51,0
2023,1,المنطقة الشرقية,أنشطة الأمن والتحقيقات,متوسطة,16,1419,1342,77,81,81,0
2023,1,منطقة الباحة,أنشطة الأمن والتحقيقات,صغيرة,1,7,6,1,0,0,0
2023,1,منطقة الجوف,أنشطة الأمن والتحقيقات,صغيرة,2,59,44,15,0,0,0
2023,1,منطقة الجوف,أنشطة الأمن والتحقيقات,متناهية الصغر,7,12,11,1,3,3,0
2023,1,منطقة الحدود الشمالية,أنشطة الأمن والتحقيقات,صغيرة,1,17,12,5,0,0,0
2023,1,منطقة الحدود الشمالية,أنشطة الأمن والتحقيقات,كبيرة,1,0,0,0,331,331,0
2023,1,منطقة الحدود الشمالية,أنشطة الأمن والتحقيقات,متناهية الصغر,2,1,1,0,3,2,1
2023,1,منطقة الرياض,أنشطة الأمن والتحقيقات,صغيرة,53,749,610,139,191,189,2
2023,1,منطقة الرياض,أنشطة الأمن والتحقيقات,كبيرة,20,21061,19162,1899,180,178,2
2023,1,منطقة الرياض,أنشطة الأمن والتحقيقات,متناهية الصغر,110,129,91,38,128,127,1
2023,1,منطقة الرياض,أنشطة الأمن والتحقيقات,متوسطة,21,2531,2293,238,107,104,3
2023,1,منطقة القصيم,أنشطة الأمن والتحقيقات,صغيرة,3,87,84,3,1,1,0
2023,1,منطقة القصيم,أنشطة الأمن والتحقيقات,متناهية الصغر,13,9,7,2,22,22,0
2023,1,منطقة القصيم,أنشطة الأمن والتحقيقات,متوسطة,1,52,47,5,9,5,4
2023,1,منطقة المدينة المنورة,أنشطة الأمن والتحقيقات,صغيرة,4,46,42,4,6,6,0
2023,1,منطقة المدينة المنورة,أنشطة الأمن والتحقيقات,متناهية الصغر,13,9,8,1,16,16,0
2023,1,منطقة المدينة المنورة,أنشطة الأمن والتحقيقات,متوسطة,2,179,176,3,0,0,0
2023,1,منطقة تبوك,أنشطة الأمن والتحقيقات,متناهية الصغر,8,5,4,1,10,10,0
2023,1,منطقة جازان,أنشطة الأمن والتحقيقات,صغيرة,3,15,14,1,13,13,0
2023,1,منطقة جازان,أنشطة الأمن والتحقيقات,كبيرة,1,257,256,1,0,0,0
2023,1,منطقة جازان,أنشطة الأمن والتحقيقات,متناهية الصغر,9,4,3,1,13,13,0
2023,1,منطقة حائل,أنشطة الأمن والتحقيقات,صغيرة,1,9,9,0,0,0,0
2023,1,منطقة حائل,أنشطة الأمن والتحقيقات,متناهية الصغر,3,4,2,2,10,10,0
2023,1,منطقة حائل,أنشطة الأمن والتحقيقات,متوسطة,1,76,73,3,0,0,0
2023,1,منطقة عسير,أنشطة الأمن والتحقيقات,صغيرة,4,74,68,6,0,0,0
2023,1,منطقة عسير,أنشطة الأمن والتحقيقات,كبيرة,2,995,972,23,0,0,0
2023,1,منطقة عسير,أنشطة الأمن والتحقيقات,متناهية الصغر,7,11,4,7,9,9,0
2023,1,منطقة مكة المكرمة,أنشطة الأمن والتحقيقات,صغيرة,37,523,458,65,40,36,4
2023,1,منطقة مكة المكرمة,أنشطة الأمن والتحقيقات,كبيرة,5,2651,2407,244,0,0,0
2023,1,منطقة مكة المكرمة,أنشطة الأمن والتحقيقات,متناهية الصغر,70,62,49,13,85,82,3
2023,1,منطقة مكة المكرمة,أنشطة الأمن والتحقيقات,متوسطة,8,1142,981,161,74,74,0
2023,1,منطقة نجران,أنشطة الأمن والتحقيقات,متناهية الصغر,2,1,0,1,4,4,0
2023,1,منطقة نجران,أنشطة الأمن والتحقيقات,متوسطة,1,236,209,27,1,1,0
2023,1,المنطقة الشرقية,أنشطة الاسر المعيشية التي تستخدم أفراداً للعمل المنزلي,صغيرة,1,3,0,3,8,8,0
2023,1,المنطقة الشرقية,أنشطة الاسر المعيشية التي تستخدم أفراداً للعمل المنزلي,متناهية الصغر,6,1,1,0,9,8,1
2023,1,منطقة الرياض,أنشطة الاسر المعيشية التي تستخدم أفراداً للعمل المنزلي,متناهية الصغر,7,1,1,0,9,8,1
2023,1,منطقة القصيم,أنشطة الاسر المعيشية التي تستخدم أفراداً للعمل المنزلي,صغيرة,1,0,0,0,7,7,0
2023,1,منطقة القصيم,أنشطة الاسر المعيشية التي تستخدم أفراداً للعمل المنزلي,متناهية الصغر,5,1,1,0,10,10,0
2023,1,منطقة المدينة المنورة,أنشطة الاسر المعيشية التي تستخدم أفراداً للعمل المنزلي,متناهية الصغر,1,0,0,0,3,3,0
2023,1,منطقة جازان,أنشطة الاسر المعيشية التي تستخدم أفراداً للعمل المنزلي,متناهية الصغر,1,1,0,1,1,0,1
2023,1,منطقة حائل,أنشطة الاسر المعيشية التي تستخدم أفراداً للعمل المنزلي,متناهية الصغر,3,0,0,0,6,6,0
2023,1,منطقة عسير,أنشطة الاسر المعيشية التي تستخدم أفراداً للعمل المنزلي,صغيرة,1,0,0,0,7,7,0
2023,1,منطقة مكة المكرمة,أنشطة الاسر المعيشية التي تستخدم أفراداً للعمل المنزلي,متناهية الصغر,1,0,0,0,1,1,0
2023,1,منطقة نجران,أنشطة الاسر المعيشية التي تستخدم أفراداً للعمل المنزلي,متناهية الصغر,1,0,0,0,1,1,0
2023,1,المنطقة الشرقية,أنشطة الاستخدام,صغيرة,49,257,124,133,373,252,121
2023,1,المنطقة الشرقية,أنشطة الاستخدام,كبيرة,21,100,70,30,53655,39649,14006
2023,1,المنطقة الشرقية,أنشطة الاستخدام,متناهية الصغر,291,310,167,143,352,331,21
2023,1,المنطقة الشرقية,أنشطة الاستخدام,متوسطة,11,503,375,128,916,484,432
2023,1,منطقة الباحة,أنشطة الاستخدام,صغيرة,1,3,1,2,4,4,0
2023,1,منطقة الباحة,أنشطة الاستخدام,متناهية الصغر,14,9,4,5,14,14,0
2023,1,منطقة الجوف,أنشطة الاستخدام,صغيرة,4,16,10,6,63,6,57
2023,1,منطقة الجوف,أنشطة الاستخدام,متناهية الصغر,28,33,10,23,27,27,0
2023,1,منطقة الحدود الشمالية,أنشطة الاستخدام,صغيرة,2,4,0,4,27,2,25
2023,1,منطقة الحدود الشمالية,أنشطة الاستخدام,متناهية الصغر,21,20,10,10,32,31,1
2023,1,منطقة الحدود الشمالية,أنشطة الاستخدام,متوسطة,1,1,0,1,169,0,169
2023,1,منطقة الرياض,أنشطة الاستخدام,صغيرة,177,1118,426,692,1281,979,302
2023,1,منطقة الرياض,أنشطة الاستخدام,كبيرة,52,10566,1522,9044,201711,116320,85391
2023,1,منطقة الرياض,أنشطة الاستخدام,متناهية الصغر,760,651,324,327,1094,1050,44
2023,1,منطقة الرياض,أنشطة الاستخدام,متوسطة,31,1615,830,785,1878,896,982
2023,1,منطقة القصيم,أنشطة الاستخدام,صغيرة,23,106,37,69,434,190,244
2023,1,منطقة القصيم,أنشطة الاستخدام,متناهية الصغر,79,73,38,35,108,107,1
2023,1,منطقة القصيم,أنشطة الاستخدام,متوسطة,1,10,2,8,184,5,179
2023,1,منطقة المدينة المنورة,أنشطة الاستخدام,صغيرة,12,51,23,28,146,25,121
2023,1,منطقة المدينة المنورة,أنشطة الاستخدام,متناهية الصغر,99,70,48,22,149,140,9
2023,1,منطقة المدينة المنورة,أنشطة الاستخدام,متوسطة,1,0,0,0,57,0,57
2023,1,منطقة تبوك,أنشطة الاستخدام,صغيرة,5,18,10,8,16,16,0
2023,1,منطقة تبوك,أنشطة الاستخدام,متناهية الصغر,53,34,16,18,73,71,2
2023,1,منطقة جازان,أنشطة الاستخدام,صغيرة,2,3,0,3,39,39,0
2023,1,منطقة جازان,أنشطة الاستخدام,متناهية الصغر,42,15,9,6,77,77,0
2023,1,منطقة حائل,أنشطة الاستخدام,صغيرة,6,41,15,26,27,26,1
2023,1,منطقة حائل,أنشطة الاستخدام,متناهية الصغر,49,44,23,21,72,71,1
2023,1,منطقة حائل,أنشطة الاستخدام,متوسطة,1,1,1,0,89,0,89
2023,1,منطقة عسير,أنشطة الاستخدام,صغيرة,13,28,9,19,123,16,107
2023,1,منطقة عسير,أنشطة الاستخدام,كبيرة,2,0,0,0,15923,10443,5480
2023,1,منطقة عسير,أنشطة الاستخدام,متناهية الصغر,124,82,47,35,182,181,1
2023,1,منطقة عسير,أنشطة الاستخدام,متوسطة,2,124,41,83,116,55,61
2023,1,منطقة مكة المكرمة,أنشطة الاستخدام,صغيرة,51,222,93,129,394,268,126
2023,1,منطقة مكة المكرمة,أنشطة الاستخدام,كبيرة,9,111,14,97,15108,12019,3089
2023,1,منطقة مكة المكرمة,أنشطة الاستخدام,متناهية الصغر,386,273,160,113,584,565,19
2023,1,منطقة مكة المكرمة,أنشطة الاستخدام,متوسطة,6,113,43,70,372,158,214
2023,1,منطقة نجران,أنشطة الاستخدام,صغيرة,5,10,6,4,54,32,22
2023,1,منطقة نجران,أنشطة الاستخدام,متناهية الصغر,53,29,11,18,90,77,13
2023,1,منطقة نجران,أنشطة الاستخدام,متوسطة,2,6,0,6,192,10,182
2023,1,المنطقة الشرقية,الأنشطه المعماريه والهندسيه,صغيرة,439,1615,852,763,6407,6383,24
2023,1,المنطقة الشرقية,الأنشطه المعماريه والهندسيه,كبيرة,98,25599,20954,4645,112816,112641,175
2023,1,المنطقة الشرقية,الأنشطه المعماريه والهندسيه,متناهية الصغر,566,294,157,137,1206,1201,5
2023,1,المنطقة الشرقية,الأنشطه المعماريه والهندسيه,متوسطة,180,4012,2809,1203,16883,16857,26
2023,1,منطقة الباحة,الأنشطه المعماريه والهندسيه,صغيرة,4,10,9,1,39,39,0
2023,1,منطقة الباحة,الأنشطه المعماريه والهندسيه,كبيرة,1,51,46,5,253,253,0
2023,1,منطقة الباحة,الأنشطه المعماريه والهندسيه,متناهية الصغر,28,9,3,6,63,63,0
2023,1,منطقة الباحة,الأنشطه المعماريه والهندسيه,متوسطة,2,40,27,13,108,108,0
2023,1,منطقة الجوف,الأنشطه المعماريه والهندسيه,صغيرة,17,39,26,13,202,202,0
2023,1,منطقة الجوف,الأنشطه المعماريه والهندسيه,كبيرة,1,121,78,43,281,263,18
2023,1,منطقة الجوف,الأنشطه المعماريه والهندسيه,متناهية الصغر,46,10,8,2,100,100,0
2023,1,منطقة الجوف,الأنشطه المعماريه والهندسيه,متوسطة,5,125,89,36,397,396,1
2023,1,منطقة الحدود الشمالية,الأنشطه المعماريه والهندسيه,صغيرة,7,33,20,13,119,119,0
2023,1,منطقة الحدود الشمالية,الأنشطه المعماريه والهندسيه,متناهية الصغر,39,10,4,6,96,95,1
2023,1,منطقة الحدود الشمالية,الأنشطه المعماريه والهندسيه,متوسطة,1,38,20,18,128,128,0
2023,1,منطقة الرياض,الأنشطه المعماريه والهندسيه,صغيرة,680,2165,1039,1126,9529,9469,60
2023,1,منطقة الرياض,الأنشطه المعماريه والهندسيه,كبيرة,123,27473,18550,8923,125563,124890,673
2023,1,منطقة الرياض,الأنشطه المعماريه والهندسيه,متناهية الصغر,1284,515,238,277,2736,2709,27
2023,1,منطقة الرياض,الأنشطه المعماريه والهندسيه,متوسطة,241,5103,3077,2026,23107,23045,62
2023,1,منطقة القصيم,الأنشطه المعماريه والهندسيه,صغيرة,70,235,150,85,1103,1102,1
2023,1,منطقة القصيم,الأنشطه المعماريه والهندسيه,كبيرة,11,1531,959,572,8428,8427,1
2023,1,منطقة القصيم,الأنشطه المعماريه والهندسيه,متناهية الصغر,158,43,29,14,387,384,3
2023,1,منطقة القصيم,الأنشطه المعماريه والهندسيه,متوسطة,22,421,344,77,2036,2031,5
2023,1,منطقة المدينة المنورة,الأنشطه المعماريه والهندسيه,صغيرة,74,243,150,93,979,977,2
2023,1,منطقة المدينة المنورة,الأنشطه المعماريه والهندسيه,كبيرة,9,950,635,315,3932,3906,26
2023,1,منطقة المدينة المنورة,الأنشطه المعماريه والهندسيه,متناهية الصغر,187,52,29,23,445,443,2
2023,1,منطقة المدينة المنورة,الأنشطه المعماريه والهندسيه,متوسطة,22,523,374,149,1884,1882,2
2023,1,منطقة تبوك,الأنشطه المعماريه والهندسيه,صغيرة,20,64,31,33,261,261,0
2023,1,منطقة تبوك,الأنشطه المعماريه والهندسيه,كبيرة,1,101,50,51,496,496,0
2023,1,منطقة تبوك,الأنشطه المعماريه والهندسيه,متناهية الصغر,78,21,8,13,167,166,1
2023,1,منطقة تبوك,الأنشطه المعماريه والهندسيه,متوسطة,4,83,55,28,300,300,0
2023,1,منطقة جازان,الأنشطه المعماريه والهندسيه,صغيرة,22,45,20,25,325,324,1
2023,1,منطقة جازان,الأنشطه المعماريه والهندسيه,كبيرة,1,59,52,7,326,326,0
2023,1,منطقة جازان,الأنشطه المعماريه والهندسيه,متناهية الصغر,107,23,10,13,264,264,0
2023,1,منطقة جازان,الأنشطه المعماريه والهندسيه,متوسطة,6,147,90,57,639,639,0
2023,1,منطقة حائل,الأنشطه المعماريه والهندسيه,صغيرة,25,68,42,26,311,310,1
2023,1,منطقة حائل,الأنشطه المعماريه والهندسيه,كبيرة,1,125,79,46,641,641,0
2023,1,منطقة حائل,الأنشطه المعماريه والهندسيه,متناهية الصغر,70,13,6,7,175,173,2
2023,1,منطقة حائل,الأنشطه المعماريه والهندسيه,متوسطة,7,154,117,37,649,645,4
2023,1,منطقة عسير,الأنشطه المعماريه والهندسيه,صغيرة,55,145,79,66,630,628,2
2023,1,منطقة عسير,الأنشطه المعماريه والهندسيه,كبيرة,8,682,560,122,3499,3499,0
2023,1,منطقة عسير,الأنشطه المعماريه والهندسيه,متناهية الصغر,151,49,29,20,361,361,0
2023,1,منطقة عسير,الأنشطه المعماريه والهندسيه,متوسطة,26,594,432,162,2388,2387,1
2023,1,منطقة مكة المكرمة,الأنشطه المعماريه والهندسيه,صغيرة,342,1183,621,562,4643,4612,31
2023,1,منطقة مكة المكرمة,الأنشطه المعماريه والهندسيه,كبيرة,38,7335,5319,2016,34802,34710,92
2023,1,منطقة مكة المكرمة,الأنشطه المعماريه والهندسيه,متناهية الصغر,686,246,126,120,1551,1530,21
2023,1,منطقة مكة المكرمة,الأنشطه المعماريه والهندسيه,متوسطة,97,2034,1315,719,8584,8551,33
2023,1,منطقة نجران,الأنشطه المعماريه والهندسيه,صغيرة,21,80,36,44,304,304,0
2023,1,منطقة نجران,الأنشطه المعماريه والهندسيه,كبيرة,6,845,600,245,3401,3401,0
2023,1,منطقة نجران,الأنشطه المعماريه والهندسيه,متناهية الصغر,61,19,7,12,141,140,1
2023,1,منطقة نجران,الأنشطه المعماريه والهندسيه,متوسطة,9,137,79,58,706,704,2
2023,1,المنطقة الشرقية,النقل,صغيرة,28,166,119,47,230,225,5
2023,1,المنطقة الشرقية,النقل,متناهية الصغر,47,38,33,5,69,69,0
2023,1,المنطقة الشرقية,النقل,متوسطة,13,793,629,164,364,357,7
2023,1,منطقة الباحة,النقل,متناهية الصغر,1,0,0,0,2,2,0
2023,1,منطقة الحدود الشمالية,النقل,متناهية الصغر,1,0,0,0,1,1,0
2023,1,منطقة الرياض,النقل,صغيرة,17,130,60,70,173,172,1
2023,1,منطقة الرياض,النقل,متناهية الصغر,119,33,19,14,273,269,4
2023,1,منطقة الرياض,النقل,متوسطة,2,173,150,23,73,72,1
2023,1,منطقة القصيم,النقل,صغيرة,1,0,0,0,8,8,0
2023,1,منطقة القصيم,النقل,متناهية الصغر,5,1,0,1,11,11,0
2023,1,منطقة المدينة المنورة,النقل,صغيرة,6,37,29,8,45,45,0
2023,1,منطقة المدينة المنورة,النقل,متناهية الصغر,22,15,10,5,35,35,0
2023,1,منطقة المدينة المنورة,النقل,متوسطة,2,62,46,16,58,56,2
2023,1,منطقة تبوك,النقل,صغيرة,2,7,3,4,27,15,12
2023,1,منطقة تبوك,النقل,متناهية الصغر,13,8,8,0,20,20,0
2023,1,منطقة جازان,النقل,صغيرة,3,50,33,17,14,14,0
2023,1,منطقة جازان,النقل,متناهية الصغر,13,5,3,2,24,24,0
2023,1,منطقة حائل,النقل,متناهية الصغر,4,3,1,2,5,5,0
2023,1,منطقة عسير,النقل,متناهية الصغر,13,1,1,0,34,34,0
2023,1,منطقة مكة المكرمة,النقل,صغيرة,37,188,133,55,293,287,6
2023,1,منطقة مكة المكرمة,النقل,متناهية الصغر,122,45,22,23,206,202,4
2023,1,منطقة مكة المكرمة,النقل,متوسطة,5,176,114,62,195,194,1
2023,1,منطقة نجران,النقل,صغيرة,1,0,0,0,6,6,0
2023,1,منطقة نجران,النقل,متناهية الصغر,5,0,0,0,9,9,0
2023,1,المنطقة الشرقية,النقل,صغيرة,16,103,78,25,119,118,1
2023,1,المنطقة الشرقية,النقل,متناهية الصغر,61,17,9,8,110,110,0
2023,1,منطقة الجوف,النقل,صغيرة,1,0,0,0,8,8,0
2023,1,منطقة الجوف,النقل,متناهية الصغر,7,1,1,0,18,18,0
2023,1,منطقة الحدود الشمالية,النقل,صغيرة,2,11,8,3,25,25,0
2023,1,منطقة الرياض,النقل,صغيرة,22,131,88,43,231,231,0
2023,1,منطقة الرياض,النقل,كبيرة,2,1742,1597,145,1406,786,620
2023,1,منطقة الرياض,النقل,متناهية الصغر,223,43,25,18,562,558,4
2023,1,منطقة الرياض,النقل,متوسطة,7,282,216,66,272,238,34
2023,1,منطقة القصيم,النقل,صغيرة,1,1,0,1,5,5,0
2023,1,منطقة القصيم,النقل,متناهية الصغر,10,3,1,2,19,19,0
2023,1,منطقة المدينة المنورة,النقل,صغيرة,2,25,23,2,20,20,0
2023,1,منطقة المدينة المنورة,النقل,متناهية الصغر,10,3,2,1,22,22,0
2023,1,منطقة تبوك,النقل,صغيرة,2,16,13,3,30,30,0
2023,1,منطقة تبوك,النقل,متناهية الصغر,6,0,0,0,11,11,0
2023,1,منطقة جازان,النقل,متناهية الصغر,11,1,1,0,27,27,0
2023,1,منطقة حائل,النقل,متناهية الصغر,16,0,0,0,46,45,1
2023,1,منطقة عسير,النقل,صغيرة,1,0,0,0,7,7,0
2023,1,منطقة عسير,النقل,متناهية الصغر,12,6,4,2,24,24,0
2023,1,منطقة مكة المكرمة,النقل,صغيرة,25,179,133,46,248,241,7
2023,1,منطقة مكة المكرمة,النقل,كبيرة,2,5949,5353,596,258,130,128
2023,1,منطقة مكة المكرمة,النقل,متناهية الصغر,86,55,36,19,162,161,1
2023,1,منطقة مكة المكرمة,النقل,متوسطة,3,122,95,27,119,119,0
2023,1,منطقة نجران,النقل,متناهية الصغر,2,0,0,0,5,5,0
2023,1,المنطقة الشرقية,النقل,صغيرة,822,2883,1570,1313,12125,12112,13
2023,1,المنطقة الشرقية,النقل,كبيرة,51,9121,7438,1683,23519,23509,10
2023,1,المنطقة الشرقية,النقل,متناهية الصغر,2016,547,259,288,4103,4092,11
2023,1,المنطقة الشرقية,النقل,متوسطة,218,4952,3201,1751,16374,16353,21
2023,1,منطقة الباحة,النقل,صغيرة,8,23,11,12,167,167,0
2023,1,منطقة الباحة,النقل,متناهية الصغر,183,40,27,13,376,375,1
2023,1,منطقة الجوف,النقل,صغيرة,88,176,109,67,1024,1024,0
2023,1,منطقة الجوف,النقل,متناهية الصغر,570,54,33,21,1240,1234,6
2023,1,منطقة الجوف,النقل,متوسطة,8,133,58,75,504,504,0
2023,1,منطقة الحدود الشمالية,النقل,صغيرة,66,155,70,85,746,746,0
2023,1,منطقة الحدود الشمالية,النقل,متناهية الصغر,317,37,21,16,624,624,0
2023,1,منطقة الحدود الشمالية,النقل,متوسطة,1,50,36,14,152,152,0
2023,1,منطقة الرياض,النقل,صغيرة,1266,3642,1527,2115,16153,16097,56
2023,1,منطقة الرياض,النقل,كبيرة,59,18597,15922,2675,31538,31515,23
2023,1,منطقة الرياض,النقل,متناهية الصغر,13719,1605,720,885,36819,36651,168
2023,1,منطقة الرياض,النقل,متوسطة,240,5427,2926,2501,19368,19341,27
2023,1,منطقة القصيم,النقل,صغيرة,275,759,393,366,3280,3271,9
2023,1,منطقة القصيم,النقل,كبيرة,7,638,550,88,2164,2164,0
2023,1,منطقة القصيم,النقل,متناهية الصغر,1151,211,107,104,2576,2572,4
2023,1,منطقة القصيم,النقل,متوسطة,32,627,395,232,2377,2369,8
2023,1,منطقة المدينة المنورة,النقل,صغيرة,164,412,216,196,1976,1976,0
2023,1,منطقة المدينة المنورة,النقل,كبيرة,1,101,40,61,309,309,0
2023,1,منطقة المدينة المنورة,النقل,متناهية الصغر,1037,146,80,66,2120,2118,2
2023,1,منطقة المدينة المنورة,النقل,متوسطة,25,499,336,163,1652,1652,0
2023,1,منطقة تبوك,النقل,صغيرة,73,137,57,80,698,697,1
2023,1,منطقة تبوك,النقل,كبيرة,1,71,65,6,195,195,0
2023,1,منطقة تبوك,النقل,متناهية الصغر,618,83,47,36,1249,1247,2
2023,1,منطقة تبوك,النقل,متوسطة,6,156,115,41,245,245,0
2023,1,منطقة جازان,النقل,صغيرة,36,75,39,36,377,376,1
2023,1,منطقة جازان,النقل,كبيرة,2,822,629,193,300,286,14
2023,1,منطقة جازان,النقل,متناهية الصغر,587,70,38,32,1340,1331,9
2023,1,منطقة جازان,النقل,متوسطة,6,89,35,54,398,398,0
2023,1,منطقة حائل,النقل,صغيرة,59,108,52,56,612,612,0
2023,1,منطقة حائل,النقل,متناهية الصغر,668,72,34,38,1705,1702,3
2023,1,منطقة حائل,النقل,متوسطة,3,30,10,20,129,129,0
2023,1,منطقة عسير,النقل,صغيرة,283,712,422,290,3102,3093,9
2023,1,منطقة عسير,النقل,كبيرة,2,131,106,25,394,394,0
2023,1,منطقة عسير,النقل,متناهية الصغر,1836,254,132,122,3722,3715,7
2023,1,منطقة عسير,النقل,متوسطة,16,391,255,136,1223,1223,0
2023,1,منطقة مكة المكرمة,النقل,صغيرة,1015,3235,1533,1702,13114,13059,55
2023,1,منطقة مكة المكرمة,النقل,كبيرة,24,3633,2669,964,11416,11372,44
2023,1,منطقة مكة المكرمة,النقل,متناهية الصغر,3715,695,361,334,8078,7989,89
2023,1,منطقة مكة المكرمة,النقل,متوسطة,148,3318,1943,1375,10904,10844,60
2023,1,منطقة نجران,النقل,صغيرة,103,209,92,117,1213,1212,1
2023,1,منطقة نجران,النقل,متناهية الصغر,995,75,34,41,2508,2502,6
2023,1,منطقة نجران,النقل,متوسطة,5,104,72,32,381,381,0
2023,1,المنطقة الشرقية,الطباعة واستنساخ وسائط الأعلام المسجّلة,صغيرة,55,242,100,142,586,585,1
2023,1,المنطقة الشرقية,الطباعة واستنساخ وسائط الأعلام المسجّلة,كبيرة,1,491,337,154,367,362,5
2023,1,المنطقة الشرقية,الطباعة واستنساخ وسائط الأعلام المسجّلة,متناهية الصغر,89,60,30,30,152,149,3
2023,1,المنطقة الشرقية,الطباعة واستنساخ وسائط الأعلام المسجّلة,متوسطة,3,63,24,39,191,191,0
2023,1,منطقة الباحة,الطباعة واستنساخ وسائط الأعلام المسجّلة,صغيرة,3,4,2,2,15,15,0
2023,1,منطقة الباحة,الطباعة واستنساخ وسائط الأعلام المسجّلة,متناهية الصغر,7,4,2,2,13,13,0
2023,1,منطقة الجوف,الطباعة واستنساخ وسائط الأعلام المسجّلة,متناهية الصغر,11,3,2,1,21,21,0
2023,1,منطقة الحدود الشمالية,الطباعة واستنساخ وسائط الأعلام المسجّلة,صغيرة,2,2,0,2,10,10,0
2023,1,منطقة الحدود الشمالية,الطباعة واستنساخ وسائط الأعلام المسجّلة,متناهية الصغر,5,1,1,0,10,10,0
2023,1,منطقة الرياض,الطباعة واستنساخ وسائط الأعلام المسجّلة,صغيرة,158,824,308,516,1819,1805,14
2023,1,منطقة الرياض,الطباعة واستنساخ وسائط الأعلام المسجّلة,متناهية الصغر,269,143,62,81,467,461,6
2023,1,منطقة الرياض,الطباعة واستنساخ وسائط الأعلام المسجّلة,متوسطة,13,465,256,209,864,860,4
2023,1,منطقة القصيم,الطباعة واستنساخ وسائط الأعلام المسجّلة,صغيرة,10,66,22,44,126,126,0
2023,1,منطقة القصيم,الطباعة واستنساخ وسائط الأعلام المسجّلة,متناهية الصغر,29,16,9,7,57,56,1
2023,1,منطقة القصيم,الطباعة واستنساخ وسائط الأعلام المسجّلة,متوسطة,1,16,7,9,49,49,0
2023,1,منطقة المدينة المنورة,الطباعة واستنساخ وسائط الأعلام المسجّلة,صغيرة,12,29,10,19,93,92,1
2023,1,منطقة المدينة المنورة,الطباعة واستنساخ وسائط الأعلام المسجّلة,متناهية الصغر,38,13,10,3,85,85,0
2023,1,منطقة تبوك,الطباعة واستنساخ وسائط الأعلام المسجّلة,صغيرة,6,14,5,9,54,53,1
2023,1,منطقة تبوك,الطباعة واستنساخ وسائط الأعلام المسجّلة,متناهية الصغر,16,11,4,7,32,32,0
2023,1,منطقة جازان,الطباعة واستنساخ وسائط الأعلام المسجّلة,صغيرة,2,8,4,4,14,14,0
2023,1,منطقة جازان,الطباعة واستنساخ وسائط الأعلام المسجّلة,متناهية الصغر,12,2,1,1,27,27,0
2023,1,منطقة حائل,الطباعة واستنساخ وسائط الأعلام المسجّلة,صغيرة,3,9,5,4,30,30,0
2023,1,منطقة حائل,الطباعة واستنساخ وسائط الأعلام المسجّلة,متناهية الصغر,18,5,3,2,35,35,0
2023,1,منطقة عسير,الطباعة واستنساخ وسائط الأعلام المسجّلة,صغيرة,7,33,16,17,76,76,0
2023,1,منطقة عسير,الطباعة واستنساخ وسائط الأعلام المسجّلة,متناهية الصغر,28,18,11,7,52,51,1
2023,1,منطقة مكة المكرمة,الطباعة واستنساخ وسائط الأعلام المسجّلة,صغيرة,79,365,160,205,867,862,5
2023,1,منطقة مكة المكرمة,الطباعة واستنساخ وسائط الأعلام المسجّلة,متناهية الصغر,196,63,33,30,368,357,11
2023,1,منطقة مكة المكرمة,الطباعة واستنساخ وسائط الأعلام المسجّلة,متوسطة,7,184,71,113,345,340,5
2023,1,منطقة نجران,الطباعة واستنساخ وسائط الأعلام المسجّلة,صغيرة,1,6,3,3,14,14,0
2023,1,منطقة نجران,الطباعة واستنساخ وسائط الأعلام المسجّلة,متناهية الصغر,9,4,3,1,24,24,0
2023,1,المنطقة الشرقية,الصناعة,صغيرة,85,398,289,109,1116,1111,5
2023,1,المنطقة الشرقية,الصناعة,كبيرة,6,914,843,71,1573,1569,4
2023,1,المنطقة الشرقية,الصناعة,متناهية الصغر,102,72,48,24,182,178,4
2023,1,المنطقة الشرقية,الصناعة,متوسطة,24,538,356,182,1465,1461,4
2023,1,منطقة الباحة,الصناعة,صغيرة,1,1,1,0,5,5,0
2023,1,منطقة الباحة,الصناعة,متناهية الصغر,9,3,2,1,21,20,1
2023,1,منطقة الجوف,الصناعة,صغيرة,2,1,1,0,19,19,0
2023,1,منطقة الجوف,الصناعة,متناهية الصغر,7,1,1,0,11,11,0
2023,1,منطقة الحدود الشمالية,الصناعة,متناهية الصغر,4,0,0,0,10,10,0
2023,1,منطقة الرياض,الصناعة,صغيرة,177,780,333,447,2876,2729,147
2023,1,منطقة الرياض,الصناعة,كبيرة,6,711,262,449,2162,2140,22
2023,1,منطقة الرياض,الصناعة,متناهية الصغر,198,99,54,45,435,423,12
2023,1,منطقة الرياض,الصناعة,متوسطة,59,1424,838,586,4321,4263,58
2023,1,منطقة القصيم,الصناعة,صغيرة,7,42,33,9,94,94,0
2023,1,منطقة القصيم,الصناعة,متناهية الصغر,22,13,13,0,39,39,0
2023,1,منطقة القصيم,الصناعة,متوسطة,4,119,32,87,344,344,0
2023,1,منطقة المدينة المنورة,الصناعة,صغيرة,7,20,13,7,73,72,1
2023,1,منطقة المدينة المنورة,الصناعة,متناهية الصغر,31,16,10,6,52,51,1
2023,1,منطقة تبوك,الصناعة,صغيرة,2,9,4,5,14,14,0
2023,1,منطقة تبوك,الصناعة,متناهية الصغر,11,2,2,0,25,22,3
2023,1,منطقة جازان,الصناعة,صغيرة,3,6,3,3,25,25,0
2023,1,منطقة جازان,الصناعة,متناهية الصغر,17,5,4,1,39,39,0
2023,1,منطقة حائل,الصناعة,صغيرة,2,6,5,1,11,11,0
2023,1,منطقة حائل,الصناعة,متناهية الصغر,15,4,3,1,36,35,1
2023,1,منطقة عسير,الصناعة,صغيرة,17,47,29,18,178,174,4
2023,1,منطقة عسير,الصناعة,متناهية الصغر,32,16,14,2,70,67,3
2023,1,منطقة مكة المكرمة,الصناعة,صغيرة,108,490,214,276,1498,1477,21
2023,1,منطقة مكة المكرمة,الصناعة,كبيرة,7,887,628,259,2711,2696,15
2023,1,منطقة مكة المكرمة,الصناعة,متناهية الصغر,169,84,47,37,325,313,12
2023,1,منطقة مكة المكرمة,الصناعة,متوسطة,22,515,300,215,1713,1708,5
2023,1,منطقة نجران,الصناعة,صغيرة,2,10,4,6,17,13,4
2023,1,منطقة نجران,الصناعة,متناهية الصغر,5,5,4,1,10,10,0
2023,1,المنطقة الشرقية,الصرف الصحي,صغيرة,19,47,21,26,264,261,3
2023,1,المنطقة الشرقية,الصرف الصحي,كبيرة,3,325,206,119,1855,1855,0
2023,1,المنطقة الشرقية,الصرف الصحي,متناهية الصغر,33,21,10,11,82,81,1
2023,1,المنطقة الشرقية,الصرف الصحي,متوسطة,4,55,27,28,310,306,4
2023,1,منطقة الباحة,الصرف الصحي,متناهية الصغر,4,1,0,1,17,17,0
2023,1,منطقة الجوف,الصرف الصحي,متناهية الصغر,9,0,0,0,14,14,0
2023,1,منطقة الحدود الشمالية,الصرف الصحي,متناهية الصغر,4,0,0,0,10,10,0
2023,1,منطقة الرياض,الصرف الصحي,صغيرة,28,52,27,25,341,339,2
2023,1,منطقة الرياض,الصرف الصحي,كبيرة,1,1581,1190,391,8066,8051,15
2023,1,منطقة الرياض,الصرف الصحي,متناهية الصغر,113,19,11,8,251,250,1
2023,1,منطقة الرياض,الصرف الصحي,متوسطة,6,118,78,40,671,671,0
2023,1,منطقة القصيم,الصرف الصحي,صغيرة,5,13,7,6,69,68,1
2023,1,منطقة القصيم,الصرف الصحي,متناهية الصغر,27,7,7,0,62,62,0
2023,1,منطقة القصيم,الصرف الصحي,متوسطة,1,21,18,3,107,107,0
2023,1,منطقة المدينة المنورة,الصرف الصحي,صغيرة,12,14,9,5,123,123,0
2023,1,منطقة المدينة المنورة,الصرف الصحي,متناهية الصغر,11,1,1,0,25,25,0
2023,1,منطقة المدينة المنورة,الصرف الصحي,متوسطة,1,101,101,0,24,24,0
2023,1,منطقة تبوك,الصرف الصحي,صغيرة,1,1,0,1,7,7,0
2023,1,منطقة تبوك,الصرف الصحي,متناهية الصغر,5,2,1,1,12,11,1
2023,1,منطقة جازان,الصرف الصحي,صغيرة,1,2,1,1,6,6,0
2023,1,منطقة جازان,الصرف الصحي,متناهية الصغر,26,4,3,1,59,59,0
2023,1,منطقة حائل,الصرف الصحي,صغيرة,5,19,16,3,70,70,0
2023,1,منطقة حائل,الصرف الصحي,متناهية الصغر,12,1,1,0,23,23,0
2023,1,منطقة حائل,الصرف الصحي,متوسطة,1,12,9,3,61,61,0
2023,1,منطقة عسير,الصرف الصحي,صغيرة,2,3,2,1,37,37,0
2023,1,منطقة عسير,الصرف الصحي,متناهية الصغر,10,2,1,1,21,21,0
2023,1,منطقة عسير,الصرف الصحي,متوسطة,1,21,15,6,63,63,0
2023,1,منطقة مكة المكرمة,الصرف الصحي,صغيرة,20,28,16,12,234,232,2
2023,1,منطقة مكة المكرمة,الصرف الصحي,كبيرة,1,329,294,35,1549,1549,0
2023,1,منطقة مكة المكرمة,الصرف الصحي,متناهية الصغر,80,30,18,12,187,186,1
2023,1,منطقة مكة المكرمة,الصرف الصحي,متوسطة,5,104,87,17,282,281,1
2023,1,منطقة نجران,الصرف الصحي,متناهية الصغر,3,0,0,0,3,3,0
2023,1,المنطقة الشرقية,الصحة البشرية,صغيرة,341,2625,609,2016,4546,2218,2328
2023,1,المنطقة الشرقية,الصحة البشرية,كبيرة,32,9501,3385,6116,15010,6688,8322
2023,1,المنطقة الشرقية,الصحة البشرية,متناهية الصغر,206,218,65,153,340,238,102
2023,1,المنطقة الشرقية,الصحة البشرية,متوسطة,108,4293,1067,3226,7112,3842,3270
2023,1,منطقة الباحة,الصحة البشرية,صغيرة,33,218,75,143,394,164,230
2023,1,منطقة الباحة,الصحة البشرية,متناهية الصغر,22,19,9,10,35,24,11
2023,1,منطقة الباحة,الصحة البشرية,متوسطة,2,35,13,22,71,29,42
2023,1,منطقة الجوف,الصحة البشرية,صغيرة,42,274,86,188,459,244,215
2023,1,منطقة الجوف,الصحة البشرية,متناهية الصغر,26,25,8,17,44,33,11
2023,1,منطقة الجوف,الصحة البشرية,متوسطة,8,202,57,145,366,195,171
2023,1,منطقة الحدود الشمالية,الصحة البشرية,صغيرة,33,174,40,134,376,212,164
2023,1,منطقة الحدود الشمالية,الصحة البشرية,متناهية الصغر,19,22,6,16,34,24,10
2023,1,منطقة الحدود الشمالية,الصحة البشرية,متوسطة,6,131,38,93,256,124,132
2023,1,منطقة الرياض,الصحة البشرية,صغيرة,951,6743,1955,4788,12834,6213,6621
2023,1,منطقة الرياض,الصحة البشرية,كبيرة,79,12557,4917,7640,58464,45418,13046
2023,1,منطقة الرياض,الصحة البشرية,متناهية الصغر,645,485,176,309,1050,704,346
2023,1,منطقة الرياض,الصحة البشرية,متوسطة,287,8898,2606,6292,17854,9141,8713
2023,1,منطقة القصيم,الصحة البشرية,صغيرة,117,918,308,610,1526,626,900
2023,1,منطقة القصيم,الصحة البشرية,كبيرة,6,722,351,371,2730,1877,853
2023,1,منطقة القصيم,الصحة البشرية,متناهية الصغر,67,44,27,17,113,80,33
2023,1,منطقة القصيم,الصحة البشرية,متوسطة,29,794,320,474,1808,847,961
2023,1,منطقة المدينة المنورة,الصحة البشرية,صغيرة,173,1293,375,918,2221,1005,1216
2023,1,منطقة المدينة المنورة,الصحة البشرية,كبيرة,10,1496,613,883,2903,1518,1385
2023,1,منطقة المدينة المنورة,الصحة البشرية,متناهية الصغر,87,77,41,36,138,87,51
2023,1,منطقة المدينة المنورة,الصحة البشرية,متوسطة,30,765,238,527,1432,646,786
2023,1,منطقة تبوك,الصحة البشرية,صغيرة,66,438,107,331,726,358,368
2023,1,منطقة تبوك,الصحة البشرية,كبيرة,1,115,57,58,221,135,86
2023,1,منطقة تبوك,الصحة البشرية,متناهية الصغر,30,20,3,17,53,46,7
2023,1,منطقة تبوك,الصحة البشرية,متوسطة,14,420,84,336,694,370,324
2023,1,منطقة جازان,الصحة البشرية,صغيرة,107,869,201,668,1184,529,655
2023,1,منطقة جازان,الصحة البشرية,كبيرة,2,340,142,198,721,260,461
2023,1,منطقة جازان,الصحة البشرية,متناهية الصغر,73,55,18,37,120,99,21
2023,1,منطقة جازان,الصحة البشرية,متوسطة,19,624,167,457,1076,584,492
2023,1,منطقة حائل,الصحة البشرية,صغيرة,59,326,91,235,655,334,321
2023,1,منطقة حائل,الصحة البشرية,كبيرة,2,274,96,178,591,250,341
2023,1,منطقة حائل,الصحة البشرية,متناهية الصغر,51,42,14,28,99,77,22
2023,1,منطقة حائل,الصحة البشرية,متوسطة,17,597,180,417,1104,539,565
2023,1,منطقة عسير,الصحة البشرية,صغيرة,210,1536,425,1111,2573,1128,1445
2023,1,منطقة عسير,الصحة البشرية,كبيرة,6,1188,508,680,3694,2438,1256
2023,1,منطقة عسير,الصحة البشرية,متناهية الصغر,105,94,28,66,176,133,43
2023,1,منطقة عسير,الصحة البشرية,متوسطة,38,1245,348,897,2327,1083,1244
2023,1,منطقة مكة المكرمة,الصحة البشرية,صغيرة,730,5730,1483,4247,8845,4193,4652
2023,1,منطقة مكة المكرمة,الصحة البشرية,كبيرة,31,6814,2496,4318,13125,6505,6620
2023,1,منطقة مكة المكرمة,الصحة البشرية,متناهية الصغر,435,372,132,240,693,507,186
2023,1,منطقة مكة المكرمة,الصحة البشرية,متوسطة,182,6089,1666,4423,11406,5631,5775
2023,1,منطقة نجران,الصحة البشرية,صغيرة,62,380,148,232,765,372,393
2023,1,منطقة نجران,الصحة البشرية,كبيرة,3,179,127,52,611,449,162
2023,1,منطقة نجران,الصحة البشرية,متناهية الصغر,37,21,12,9,69,46,23
2023,1,منطقة نجران,الصحة البشرية,متوسطة,7,242,112,130,467,251,216
2023,1,المنطقة الشرقية,الرعاية مع الإقامة,صغيرة,14,216,12,204,80,39,41
2023,1,المنطقة الشرقية,الرعاية مع الإقامة,متناهية الصغر,2,5,0,5,0,0,0
2023,1,المنطقة الشرقية,الرعاية مع الإقامة,متوسطة,1,53,12,41,77,55,22
2023,1,منطقة الجوف,الرعاية مع الإقامة,صغيرة,2,57,0,57,0,0,0
2023,1,منطقة الجوف,الرعاية مع الإقامة,متناهية الصغر,2,1,0,1,1,1,0
2023,1,منطقة الرياض,الرعاية مع الإقامة,صغيرة,27,531,67,464,134,68,66
2023,1,منطقة الرياض,الرعاية مع الإقامة,متناهية الصغر,15,14,6,8,21,15,6
2023,1,منطقة الرياض,الرعاية مع الإقامة,متوسطة,6,409,55,354,199,128,71
2023,1,منطقة القصيم,الرعاية مع الإقامة,صغيرة,1,12,0,12,4,0,4
2023,1,منطقة القصيم,الرعاية مع الإقامة,متناهية الصغر,1,1,0,1,0,0,0
2023,1,منطقة القصيم,الرعاية مع الإقامة,متوسطة,4,220,61,159,79,55,24
2023,1,منطقة المدينة المنورة,الرعاية مع الإقامة,صغيرة,5,97,34,63,36,27,9
2023,1,منطقة المدينة المنورة,الرعاية مع الإقامة,متناهية الصغر,4,8,7,1,3,3,0
2023,1,منطقة تبوك,الرعاية مع الإقامة,صغيرة,3,57,2,55,9,5,4
2023,1,منطقة تبوك,الرعاية مع الإقامة,متوسطة,1,44,1,43,10,5,5
2023,1,منطقة جازان,الرعاية مع الإقامة,صغيرة,2,44,1,43,4,0,4
2023,1,منطقة جازان,الرعاية مع الإقامة,متناهية الصغر,1,3,0,3,0,0,0
2023,1,منطقة جازان,الرعاية مع الإقامة,متوسطة,1,62,1,61,11,4,7
2023,1,منطقة حائل,الرعاية مع الإقامة,صغيرة,2,30,8,22,5,4,1
2023,1,منطقة عسير,الرعاية مع الإقامة,صغيرة,5,79,12,67,26,14,12
2023,1,منطقة عسير,الرعاية مع الإقامة,متناهية الصغر,1,0,0,0,1,1,0
2023,1,منطقة عسير,الرعاية مع الإقامة,متوسطة,2,115,2,113,8,0,8
2023,1,منطقة مكة المكرمة,الرعاية مع الإقامة,صغيرة,20,412,87,325,143,101,42
2023,1,منطقة مكة المكرمة,الرعاية مع الإقامة,متناهية الصغر,14,24,3,21,12,7,5
2023,1,منطقة مكة المكرمة,الرعاية مع الإقامة,متوسطة,4,216,7,209,71,35,36
2023,1,منطقة نجران,الرعاية مع الإقامة,صغيرة,1,17,9,8,6,2,4
2023,1,المنطقة الشرقية,الحراجة وقطع الأخشاب,متناهية الصغر,4,3,3,0,11,11,0
2023,1,منطقة الجوف,الحراجة وقطع الأخشاب,متناهية الصغر,1,0,0,0,2,2,0
2023,1,منطقة الرياض,الحراجة وقطع الأخشاب,صغيرة,1,4,1,3,27,27,0
2023,1,منطقة الرياض,الحراجة وقطع الأخشاب,متناهية الصغر,7,2,0,2,16,16,0
2023,1,منطقة المدينة المنورة,الحراجة وقطع الأخشاب,متناهية الصغر,2,1,0,1,3,3,0
2023,1,منطقة جازان,الحراجة وقطع الأخشاب,متناهية الصغر,1,1,0,1,0,0,0
2023,1,منطقة حائل,الحراجة وقطع الأخشاب,متناهية الصغر,1,0,0,0,2,2,0
2023,1,منطقة مكة المكرمة,الحراجة وقطع الأخشاب,متناهية الصغر,3,2,1,1,10,10,0
2023,1,المنطقة الشرقية,التعليم,صغيرة,304,3867,1013,2854,2237,1963,274
2023,1,المنطقة الشرقية,التعليم,كبيرة,14,4359,1931,2428,1222,1057,165
2023,1,المنطقة الشرقية,التعليم,متناهية الصغر,371,388,153,235,490,442,48
2023,1,المنطقة الشرقية,التعليم,متوسطة,95,5702,1795,3907,4338,3576,762
2023,1,منطقة الباحة,التعليم,صغيرة,12,128,55,73,109,85,24
2023,1,منطقة الباحة,التعليم,متناهية الصغر,15,13,3,10,23,20,3
2023,1,منطقة الجوف,التعليم,صغيرة,35,534,226,308,275,248,27
2023,1,منطقة الجوف,التعليم,متناهية الصغر,51,39,21,18,85,82,3
2023,1,منطقة الجوف,التعليم,متوسطة,8,416,164,252,301,273,28
2023,1,منطقة الحدود الشمالية,التعليم,صغيرة,18,200,142,58,147,141,6
2023,1,منطقة الحدود الشمالية,التعليم,متناهية الصغر,23,24,5,19,32,32,0
2023,1,منطقة الحدود الشمالية,التعليم,متوسطة,3,212,67,145,90,70,20
2023,1,منطقة الرياض,التعليم,صغيرة,674,6515,1557,4958,5024,4189,835
2023,1,منطقة الرياض,التعليم,كبيرة,48,17261,8117,9144,10351,8451,1900
2023,1,منطقة الرياض,التعليم,متناهية الصغر,5750,1083,404,679,13456,13242,214
2023,1,منطقة الرياض,التعليم,متوسطة,206,12921,3828,9093,9637,8058,1579
2023,1,منطقة القصيم,التعليم,صغيرة,69,1045,271,774,354,314,40
2023,1,منطقة القصيم,التعليم,كبيرة,2,365,127,238,309,213,96
2023,1,منطقة القصيم,التعليم,متناهية الصغر,131,51,21,30,264,250,14
2023,1,منطقة القصيم,التعليم,متوسطة,17,912,427,485,642,472,170
2023,1,منطقة المدينة المنورة,التعليم,صغيرة,125,1644,319,1325,706,598,108
2023,1,منطقة المدينة المنورة,التعليم,كبيرة,3,616,279,337,248,181,67
2023,1,منطقة المدينة المنورة,التعليم,متناهية الصغر,146,139,38,101,203,189,14
2023,1,منطقة المدينة المنورة,التعليم,متوسطة,35,2042,593,1449,1208,937,271
2023,1,منطقة تبوك,التعليم,صغيرة,57,794,258,536,475,423,52
2023,1,منطقة تبوك,التعليم,متناهية الصغر,37,32,6,26,43,41,2
2023,1,منطقة تبوك,التعليم,متوسطة,19,1161,493,668,717,665,52
2023,1,منطقة جازان,التعليم,صغيرة,56,382,100,282,320,284,36
2023,1,منطقة جازان,التعليم,متناهية الصغر,91,71,10,61,139,131,8
2023,1,منطقة جازان,التعليم,متوسطة,6,274,122,152,171,109,62
2023,1,منطقة حائل,التعليم,صغيرة,35,359,77,282,142,125,17
2023,1,منطقة حائل,التعليم,متناهية الصغر,114,40,12,28,264,262,2
2023,1,منطقة حائل,التعليم,متوسطة,6,400,212,188,238,232,6
2023,1,منطقة عسير,التعليم,صغيرة,80,1082,237,845,458,385,73
2023,1,منطقة عسير,التعليم,متناهية الصغر,109,89,29,60,169,161,8
2023,1,منطقة عسير,التعليم,متوسطة,20,916,534,382,686,624,62
2023,1,منطقة مكة المكرمة,التعليم,صغيرة,402,5210,1060,4150,2556,1934,622
2023,1,منطقة مكة المكرمة,التعليم,كبيرة,17,4408,1873,2535,2221,1387,834
2023,1,منطقة مكة المكرمة,التعليم,متناهية الصغر,615,469,130,339,962,846,116
2023,1,منطقة مكة المكرمة,التعليم,متوسطة,146,8685,3487,5198,6678,5292,1386
2023,1,منطقة نجران,التعليم,صغيرة,21,275,53,222,135,127,8
2023,1,منطقة نجران,التعليم,متناهية الصغر,94,26,9,17,199,197,2
2023,1,منطقة نجران,التعليم,متوسطة,5,333,179,154,127,124,3
2023,1,المنطقة الشرقية,النقل,صغيرة,346,1703,1204,499,3613,3600,13
2023,1,المنطقة الشرقية,النقل,كبيرة,13,3883,3251,632,6135,6082,53
2023,1,المنطقة الشرقية,النقل,متناهية الصغر,733,515,388,127,1278,1274,4
2023,1,المنطقة الشرقية,النقل,متوسطة,58,2039,1539,500,2916,2903,13
2023,1,منطقة الباحة,النقل,صغيرة,5,10,2,8,25,25,0
2023,1,منطقة الباحة,النقل,متناهية الصغر,22,6,5,1,36,36,0
2023,1,منطقة الجوف,النقل,صغيرة,25,84,71,13,230,229,1
2023,1,منطقة الجوف,النقل,متناهية الصغر,96,33,30,3,163,163,0
2023,1,منطقة الحدود الشمالية,النقل,صغيرة,3,7,6,1,15,15,0
2023,1,منطقة الحدود الشمالية,النقل,متناهية الصغر,33,10,5,5,57,57,0
2023,1,منطقة الحدود الشمالية,النقل,متوسطة,1,25,25,0,48,48,0
2023,1,منطقة الرياض,النقل,صغيرة,527,2513,1281,1232,6488,6429,59
2023,1,منطقة الرياض,النقل,كبيرة,26,10193,7618,2575,8543,8452,91
2023,1,منطقة الرياض,النقل,متناهية الصغر,1803,655,362,293,4118,4093,25
2023,1,منطقة الرياض,النقل,متوسطة,122,3551,2032,1519,8975,8908,67
2023,1,منطقة القصيم,النقل,صغيرة,34,105,67,38,390,390,0
2023,1,منطقة القصيم,النقل,كبيرة,1,26,23,3,237,237,0
2023,1,منطقة القصيم,النقل,متناهية الصغر,149,35,23,12,328,325,3
2023,1,منطقة القصيم,النقل,متوسطة,7,131,87,44,660,658,2
2023,1,منطقة المدينة المنورة,النقل,صغيرة,42,211,139,72,479,478,1
2023,1,منطقة المدينة المنورة,النقل,كبيرة,2,992,896,96,329,328,1
2023,1,منطقة المدينة المنورة,النقل,متناهية الصغر,215,63,41,22,410,409,1
2023,1,منطقة المدينة المنورة,النقل,متوسطة,6,248,226,22,252,252,0
2023,1,منطقة تبوك,النقل,صغيرة,22,80,51,29,235,234,1
2023,1,منطقة تبوك,النقل,كبيرة,1,57,10,47,204,204,0
2023,1,منطقة تبوك,النقل,متناهية الصغر,88,35,24,11,182,180,2
2023,1,منطقة تبوك,النقل,متوسطة,1,29,29,0,44,44,0
2023,1,منطقة جازان,النقل,صغيرة,19,95,79,16,176,173,3
2023,1,منطقة جازان,النقل,متناهية الصغر,82,19,16,3,191,191,0
2023,1,منطقة جازان,النقل,متوسطة,2,37,15,22,141,141,0
2023,1,منطقة حائل,النقل,صغيرة,10,11,5,6,72,72,0
2023,1,منطقة حائل,النقل,متناهية الصغر,68,16,11,5,161,161,0
2023,1,منطقة عسير,النقل,صغيرة,40,161,109,52,505,504,1
2023,1,منطقة عسير,النقل,كبيرة,1,69,42,27,304,304,0
2023,1,منطقة عسير,النقل,متناهية الصغر,131,43,26,17,283,283,0
2023,1,منطقة عسير,النقل,متوسطة,3,56,55,1,166,166,0
2023,1,منطقة مكة المكرمة,النقل,صغيرة,459,2126,1355,771,5200,5152,48
2023,1,منطقة مكة المكرمة,النقل,كبيرة,21,5970,4987,983,9212,9194,18
2023,1,منطقة مكة المكرمة,النقل,متناهية الصغر,986,576,352,224,1837,1801,36
2023,1,منطقة مكة المكرمة,النقل,متوسطة,95,3604,2638,966,6663,6611,52
2023,1,منطقة نجران,النقل,صغيرة,48,52,23,29,468,467,1
2023,1,منطقة نجران,النقل,متناهية الصغر,505,47,23,24,1328,1324,4
2023,1,المنطقة الشرقية,البحث والتطوير في المجال العلمي,صغيرة,6,56,40,16,27,25,2
2023,1,المنطقة الشرقية,البحث والتطوير في المجال العلمي,متناهية الصغر,18,23,11,12,25,25,0
2023,1,المنطقة الشرقية,البحث والتطوير في المجال العلمي,متوسطة,2,133,79,54,137,131,6
2023,1,منطقة الحدود الشمالية,البحث والتطوير في المجال العلمي,متناهية الصغر,1,1,1,0,0,0,0
2023,1,منطقة الرياض,البحث والتطوير في المجال العلمي,صغيرة,34,274,142,132,198,168,30
2023,1,منطقة الرياض,البحث والتطوير في المجال العلمي,متناهية الصغر,78,76,46,30,94,84,10
2023,1,منطقة الرياض,البحث والتطوير في المجال العلمي,متوسطة,4,195,106,89,165,155,10
2023,1,منطقة القصيم,البحث والتطوير في المجال العلمي,متناهية الصغر,2,0,0,0,4,4,0
2023,1,منطقة المدينة المنورة,البحث والتطوير في المجال العلمي,صغيرة,1,5,4,1,3,3,0
2023,1,منطقة المدينة المنورة,البحث والتطوير في المجال العلمي,متناهية الصغر,10,8,5,3,14,12,2
2023,1,منطقة تبوك,البحث والتطوير في المجال العلمي,متناهية الصغر,1,0,0,0,1,1,0
2023,1,منطقة جازان,البحث والتطوير في المجال العلمي,صغيرة,1,12,7,5,1,1,0
2023,1,منطقة جازان,البحث والتطوير في المجال العلمي,متناهية الصغر,1,0,0,0,1,1,0
2023,1,منطقة حائل,البحث والتطوير في المجال العلمي,متناهية الصغر,1,4,0,4,0,0,0
2023,1,منطقة عسير,البحث والتطوير في المجال العلمي,صغيرة,3,24,3,21,5,5,0
2023,1,منطقة عسير,البحث والتطوير في المجال العلمي,متناهية الصغر,2,2,0,2,3,2,1
2023,1,منطقة مكة المكرمة,البحث والتطوير في المجال العلمي,صغيرة,12,77,44,33,94,88,6
2023,1,منطقة مكة المكرمة,البحث والتطوير في المجال العلمي,كبيرة,1,1071,1064,7,49,49,0
2023,1,منطقة مكة المكرمة,البحث والتطوير في المجال العلمي,متناهية الصغر,43,42,15,27,66,60,6
2023,1,منطقة مكة المكرمة,البحث والتطوير في المجال العلمي,متوسطة,2,110,105,5,117,117,0
2023,1,المنطقة الشرقية,الخدمات,صغيرة,1,0,0,0,12,12,0
2023,1,المنطقة الشرقية,الخدمات,متناهية الصغر,2,0,0,0,2,2,0
2023,1,منطقة الرياض,الخدمات,صغيرة,1,0,0,0,6,6,0
2023,1,منطقة القصيم,الخدمات,متناهية الصغر,1,0,0,0,1,1,0
2023,1,منطقة مكة المكرمة,الخدمات,متناهية الصغر,2,0,0,0,2,0,2
2023,1,المنطقة الشرقية,الأنشطة المهنية والعلمية والتقنية الأخرى,صغيرة,34,201,91,110,255,224,31
2023,1,المنطقة الشرقية,الأنشطة المهنية والعلمية والتقنية الأخرى,كبيرة,1,229,193,36,317,315,2
2023,1,المنطقة الشرقية,الأنشطة المهنية والعلمية والتقنية الأخرى,متناهية الصغر,229,167,64,103,344,297,47
2023,1,منطقة الباحة,الأنشطة المهنية والعلمية والتقنية الأخرى,متناهية الصغر,15,4,3,1,33,29,4
2023,1,منطقة الجوف,الأنشطة المهنية والعلمية والتقنية الأخرى,صغيرة,1,1,0,1,5,5,0
2023,1,منطقة الجوف,الأنشطة المهنية والعلمية والتقنية الأخرى,متناهية الصغر,18,5,3,2,32,24,8
2023,1,منطقة الحدود الشمالية,الأنشطة المهنية والعلمية والتقنية الأخرى,متناهية الصغر,13,6,0,6,24,21,3
2023,1,منطقة الرياض,الأنشطة المهنية والعلمية والتقنية الأخرى,صغيرة,143,850,359,491,1099,927,172
2023,1,منطقة الرياض,الأنشطة المهنية والعلمية والتقنية الأخرى,كبيرة,2,297,215,82,372,368,4
2023,1,منطقة الرياض,الأنشطة المهنية والعلمية والتقنية الأخرى,متناهية الصغر,587,362,129,233,995,863,132
2023,1,منطقة الرياض,الأنشطة المهنية والعلمية والتقنية الأخرى,متوسطة,8,567,304,263,350,329,21
2023,1,منطقة القصيم,الأنشطة المهنية والعلمية والتقنية الأخرى,صغيرة,9,65,49,16,68,67,1
2023,1,منطقة القصيم,الأنشطة المهنية والعلمية والتقنية الأخرى,متناهية الصغر,39,18,6,12,73,66,7
2023,1,منطقة المدينة المنورة,الأنشطة المهنية والعلمية والتقنية الأخرى,صغيرة,10,31,20,11,59,42,17
2023,1,منطقة المدينة المنورة,الأنشطة المهنية والعلمية والتقنية الأخرى,متناهية الصغر,113,39,19,20,195,173,22
2023,1,منطقة تبوك,الأنشطة المهنية والعلمية والتقنية الأخرى,صغيرة,1,3,3,0,5,5,0
2023,1,منطقة تبوك,الأنشطة المهنية والعلمية والتقنية الأخرى,متناهية الصغر,47,17,8,9,83,79,4
2023,1,منطقة جازان,الأنشطة المهنية والعلمية والتقنية الأخرى,صغيرة,1,12,1,11,0,0,0
2023,1,منطقة جازان,الأنشطة المهنية والعلمية والتقنية الأخرى,متناهية الصغر,48,15,6,9,80,77,3
2023,1,منطقة حائل,الأنشطة المهنية والعلمية والتقنية الأخرى,صغيرة,1,1,1,0,6,6,0
2023,1,منطقة حائل,الأنشطة المهنية والعلمية والتقنية الأخرى,متناهية الصغر,29,7,1,6,53,49,4
2023,1,منطقة عسير,الأنشطة المهنية والعلمية والتقنية الأخرى,صغيرة,6,39,20,19,35,35,0
2023,1,منطقة عسير,الأنشطة المهنية والعلمية والتقنية الأخرى,متناهية الصغر,58,22,3,19,110,101,9
2023,1,منطقة عسير,الأنشطة المهنية والعلمية والتقنية الأخرى,متوسطة,1,20,19,1,58,58,0
2023,1,منطقة مكة المكرمة,الأنشطة المهنية والعلمية والتقنية الأخرى,صغيرة,73,349,177,172,594,542,52
2023,1,منطقة مكة المكرمة,الأنشطة المهنية والعلمية والتقنية الأخرى,متناهية الصغر,460,231,72,159,823,697,126
2023,1,منطقة مكة المكرمة,الأنشطة المهنية والعلمية والتقنية الأخرى,متوسطة,4,147,123,24,121,121,0
2023,1,منطقة نجران,الأنشطة المهنية والعلمية والتقنية الأخرى,متناهية الصغر,31,1,0,1,69,65,4
2023,1,المنطقة الشرقية,الخدمات,صغيرة,31,372,205,167,150,147,3
2023,1,المنطقة الشرقية,الخدمات,كبيرة,1,254,98,156,111,106,5
2023,1,المنطقة الشرقية,الخدمات,متناهية الصغر,40,57,40,17,45,42,3
2023,1,المنطقة الشرقية,الخدمات,متوسطة,5,345,182,163,87,79,8
2023,1,منطقة الجوف,الخدمات,متناهية الصغر,1,0,0,0,2,2,0
2023,1,منطقة الرياض,الخدمات,صغيرة,166,2200,1341,859,859,809,50
2023,1,منطقة الرياض,الخدمات,كبيرة,12,23961,19011,4950,1380,1357,23
2023,1,منطقة الرياض,الخدمات,متناهية الصغر,166,215,134,81,153,148,5
2023,1,منطقة الرياض,الخدمات,متوسطة,37,3778,2529,1249,811,755,56
2023,1,منطقة القصيم,الخدمات,صغيرة,1,15,10,5,4,4,0
2023,1,منطقة القصيم,الخدمات,متناهية الصغر,5,4,1,3,9,9,0
2023,1,منطقة المدينة المنورة,الخدمات,صغيرة,5,35,28,7,4,4,0
2023,1,منطقة المدينة المنورة,الخدمات,متناهية الصغر,12,27,25,2,7,7,0
2023,1,منطقة تبوك,الخدمات,متناهية الصغر,3,4,3,1,4,4,0
2023,1,منطقة جازان,الخدمات,صغيرة,1,4,4,0,5,5,0
2023,1,منطقة حائل,الخدمات,متناهية الصغر,1,0,0,0,1,1,0
2023,1,منطقة عسير,الخدمات,متناهية الصغر,5,3,2,1,6,6,0
2023,1,منطقة مكة المكرمة,الخدمات,صغيرة,53,633,384,249,307,297,10
2023,1,منطقة مكة المكرمة,الخدمات,متناهية الصغر,73,102,72,30,90,88,2
2023,1,منطقة مكة المكرمة,الخدمات,متوسطة,11,760,494,266,243,233,10
2023,1,منطقة نجران,الخدمات,صغيرة,1,20,19,1,9,9,0
2023,1,منطقة نجران,الخدمات,متناهية الصغر,2,0,0,0,3,3,0
2023,1,المنطقة الشرقية,الأنشطة القانونية وأنشطة المحاسبة,صغيرة,126,868,534,334,541,529,12
2023,1,المنطقة الشرقية,الأنشطة القانونية وأنشطة المحاسبة,متناهية الصغر,301,440,269,171,281,272,9
2023,1,المنطقة الشرقية,الأنشطة القانونية وأنشطة المحاسبة,متوسطة,9,443,265,178,294,288,6
2023,1,منطقة الباحة,الأنشطة القانونية وأنشطة المحاسبة,صغيرة,1,10,0,10,7,1,6
2023,1,منطقة الباحة,الأنشطة القانونية وأنشطة المحاسبة,متناهية الصغر,12,12,7,5,14,14,0
2023,1,منطقة الجوف,الأنشطة القانونية وأنشطة المحاسبة,صغيرة,10,63,41,22,12,12,0
2023,1,منطقة الجوف,الأنشطة القانونية وأنشطة المحاسبة,متناهية الصغر,31,38,21,17,25,25,0
2023,1,منطقة الحدود الشمالية,الأنشطة القانونية وأنشطة المحاسبة,صغيرة,1,8,5,3,5,5,0
2023,1,منطقة الحدود الشمالية,الأنشطة القانونية وأنشطة المحاسبة,متناهية الصغر,9,13,10,3,6,6,0
2023,1,منطقة الرياض,الأنشطة القانونية وأنشطة المحاسبة,صغيرة,512,4025,2457,1568,2694,2573,121
2023,1,منطقة الرياض,الأنشطة القانونية وأنشطة المحاسبة,كبيرة,3,758,421,337,795,741,54
2023,1,منطقة الرياض,الأنشطة القانونية وأنشطة المحاسبة,متناهية الصغر,1591,1620,1032,588,2157,2115,42
2023,1,منطقة الرياض,الأنشطة القانونية وأنشطة المحاسبة,متوسطة,26,1158,664,494,1143,1084,59
2023,1,منطقة القصيم,الأنشطة القانونية وأنشطة المحاسبة,صغيرة,18,131,71,60,27,27,0
2023,1,منطقة القصيم,الأنشطة القانونية وأنشطة المحاسبة,متناهية الصغر,85,115,65,50,72,71,1
2023,1,منطقة المدينة المنورة,الأنشطة القانونية وأنشطة المحاسبة,صغيرة,30,253,150,103,109,107,2
2023,1,منطقة المدينة المنورة,الأنشطة القانونية وأنشطة المحاسبة,متناهية الصغر,93,122,78,44,83,78,5
2023,1,منطقة تبوك,الأنشطة القانونية وأنشطة المحاسبة,صغيرة,7,64,33,31,6,6,0
2023,1,منطقة تبوك,الأنشطة القانونية وأنشطة المحاسبة,متناهية الصغر,25,27,7,20,21,21,0
2023,1,منطقة جازان,الأنشطة القانونية وأنشطة المحاسبة,صغيرة,7,69,45,24,19,19,0
2023,1,منطقة جازان,الأنشطة القانونية وأنشطة المحاسبة,متناهية الصغر,39,44,28,16,50,48,2
2023,1,منطقة حائل,الأنشطة القانونية وأنشطة المحاسبة,صغيرة,4,30,29,1,15,15,0
2023,1,منطقة حائل,الأنشطة القانونية وأنشطة المحاسبة,متناهية الصغر,35,43,28,15,29,27,2
2023,1,منطقة عسير,الأنشطة القانونية وأنشطة المحاسبة,صغيرة,8,64,51,13,49,49,0
2023,1,منطقة عسير,الأنشطة القانونية وأنشطة المحاسبة,متناهية الصغر,79,91,66,25,80,80,0
2023,1,منطقة عسير,الأنشطة القانونية وأنشطة المحاسبة,متوسطة,2,70,36,34,82,82,0
2023,1,منطقة مكة المكرمة,الأنشطة القانونية وأنشطة المحاسبة,صغيرة,309,2405,1529,876,1311,1243,68
2023,1,منطقة مكة المكرمة,الأنشطة القانونية وأنشطة المحاسبة,كبيرة,1,163,57,106,122,118,4
2023,1,منطقة مكة المكرمة,الأنشطة القانونية وأنشطة المحاسبة,متناهية الصغر,770,1064,658,406,718,672,46
2023,1,منطقة مكة المكرمة,الأنشطة القانونية وأنشطة المحاسبة,متوسطة,13,929,552,377,803,776,27
2023,1,منطقة نجران,الأنشطة القانونية وأنشطة المحاسبة,صغيرة,3,15,9,6,20,20,0
2023,1,منطقة نجران,الأنشطة القانونية وأنشطة المحاسبة,متناهية الصغر,37,8,6,2,78,77,1
2023,1,المنطقة الشرقية,الأنشطة العقارية,صغيرة,217,1289,759,530,1652,1630,22
2023,1,المنطقة الشرقية,الأنشطة العقارية,كبيرة,2,156,56,100,607,607,0
2023,1,المنطقة الشرقية,الأنشطة العقارية,متناهية الصغر,732,522,313,209,1070,1059,11
2023,1,المنطقة الشرقية,الأنشطة العقارية,متوسطة,18,1060,702,358,968,949,19
2023,1,منطقة الباحة,الأنشطة العقارية,صغيرة,3,19,18,1,21,21,0
2023,1,منطقة الباحة,الأنشطة العقارية,متناهية الصغر,30,13,7,6,56,56,0
2023,1,منطقة الجوف,الأنشطة العقارية,صغيرة,7,47,28,19,69,68,1
2023,1,منطقة الجوف,الأنشطة العقارية,متناهية الصغر,55,30,15,15,89,87,2
2023,1,منطقة الحدود الشمالية,الأنشطة العقارية,صغيرة,4,20,15,5,31,31,0
2023,1,منطقة الحدود الشمالية,الأنشطة العقارية,متناهية الصغر,39,11,6,5,72,70,2
2023,1,منطقة الرياض,الأنشطة العقارية,صغيرة,754,4871,2915,1956,6268,6130,138
2023,1,منطقة الرياض,الأنشطة العقارية,كبيرة,9,2998,2055,943,1947,1893,54
2023,1,منطقة الرياض,الأنشطة العقارية,متناهية الصغر,2286,1912,1150,762,3168,3118,50
2023,1,منطقة الرياض,الأنشطة العقارية,متوسطة,61,3187,2268,919,2880,2819,61
2023,1,منطقة القصيم,الأنشطة العقارية,صغيرة,28,184,113,71,210,209,1
2023,1,منطقة القصيم,الأنشطة العقارية,كبيرة,1,51,30,21,214,214,0
2023,1,منطقة القصيم,الأنشطة العقارية,متناهية الصغر,194,103,66,37,304,299,5
2023,1,منطقة القصيم,الأنشطة العقارية,متوسطة,6,196,96,100,574,574,0
2023,1,منطقة المدينة المنورة,الأنشطة العقارية,صغيرة,43,204,136,68,347,347,0
2023,1,منطقة المدينة المنورة,الأنشطة العقارية,متناهية الصغر,300,132,82,50,510,503,7
2023,1,منطقة المدينة المنورة,الأنشطة العقارية,متوسطة,4,131,89,42,238,232,6
2023,1,منطقة تبوك,الأنشطة العقارية,صغيرة,10,53,39,14,111,110,1
2023,1,منطقة تبوك,الأنشطة العقارية,متناهية الصغر,132,51,33,18,211,211,0
2023,1,منطقة جازان,الأنشطة العقارية,صغيرة,15,32,13,19,149,148,1
2023,1,منطقة جازان,الأنشطة العقارية,متناهية الصغر,169,64,33,31,280,278,2
2023,1,منطقة جازان,الأنشطة العقارية,متوسطة,1,24,12,12,30,30,0
2023,1,منطقة حائل,الأنشطة العقارية,صغيرة,10,53,40,13,72,72,0
2023,1,منطقة حائل,الأنشطة العقارية,متناهية الصغر,89,38,20,18,142,142,0
2023,1,منطقة حائل,الأنشطة العقارية,متوسطة,1,0,0,0,59,59,0
2023,1,منطقة عسير,الأنشطة العقارية,صغيرة,35,126,87,39,241,241,0
2023,1,منطقة عسير,الأنشطة العقارية,متناهية الصغر,295,128,73,55,467,463,4
2023,1,منطقة عسير,الأنشطة العقارية,متوسطة,4,73,41,32,252,251,1
2023,1,منطقة مكة المكرمة,الأنشطة العقارية,صغيرة,457,2392,1373,1019,3922,3809,113
2023,1,منطقة مكة المكرمة,الأنشطة العقارية,كبيرة,3,927,511,416,553,531,22
2023,1,منطقة مكة المكرمة,الأنشطة العقارية,متناهية الصغر,1951,1174,683,491,3076,2998,78
2023,1,منطقة مكة المكرمة,الأنشطة العقارية,متوسطة,40,1518,1094,424,2331,2253,78
2023,1,منطقة نجران,الأنشطة العقارية,صغيرة,7,31,16,15,63,63,0
2023,1,منطقة نجران,الأنشطة العقارية,متناهية الصغر,66,9,6,3,118,117,1
2023,1,المنطقة الشرقية,الأنشطة الرياضية وأنشطة التسلية والترفيه,صغيرة,145,579,232,347,1221,1023,198
2023,1,المنطقة الشرقية,الأنشطة الرياضية وأنشطة التسلية والترفيه,متناهية الصغر,319,265,88,177,478,429,49
2023,1,المنطقة الشرقية,الأنشطة الرياضية وأنشطة التسلية والترفيه,متوسطة,8,282,99,183,436,425,11
2023,1,منطقة الباحة,الأنشطة الرياضية وأنشطة التسلية والترفيه,صغيرة,2,7,4,3,11,11,0
2023,1,منطقة الباحة,الأنشطة الرياضية وأنشطة التسلية والترفيه,متناهية الصغر,30,23,11,12,57,50,7
2023,1,منطقة الجوف,الأنشطة الرياضية وأنشطة التسلية والترفيه,صغيرة,10,45,24,21,60,60,0
2023,1,منطقة الجوف,الأنشطة الرياضية وأنشطة التسلية والترفيه,متناهية الصغر,39,15,6,9,69,63,6
2023,1,منطقة الحدود الشمالية,الأنشطة الرياضية وأنشطة التسلية والترفيه,صغيرة,9,29,10,19,69,56,13
2023,1,منطقة الحدود الشمالية,الأنشطة الرياضية وأنشطة التسلية والترفيه,متناهية الصغر,47,17,8,9,97,88,9
2023,1,منطقة الرياض,الأنشطة الرياضية وأنشطة التسلية والترفيه,صغيرة,278,1411,519,892,2613,2251,362
2023,1,منطقة الرياض,الأنشطة الرياضية وأنشطة التسلية والترفيه,كبيرة,6,1438,867,571,1900,1532,368
2023,1,منطقة الرياض,الأنشطة الرياضية وأنشطة التسلية والترفيه,متناهية الصغر,768,474,155,319,1359,1242,117
2023,1,منطقة الرياض,الأنشطة الرياضية وأنشطة التسلية والترفيه,متوسطة,29,1331,447,884,1516,1225,291
2023,1,منطقة القصيم,الأنشطة الرياضية وأنشطة التسلية والترفيه,صغيرة,49,233,103,130,361,329,32
2023,1,منطقة القصيم,الأنشطة الرياضية وأنشطة التسلية والترفيه,متناهية الصغر,75,67,30,37,103,89,14
2023,1,منطقة القصيم,الأنشطة الرياضية وأنشطة التسلية والترفيه,متوسطة,1,60,12,48,155,155,0
2023,1,منطقة المدينة المنورة,الأنشطة الرياضية وأنشطة التسلية والترفيه,صغيرة,37,181,59,122,268,247,21
2023,1,منطقة المدينة المنورة,الأنشطة الرياضية وأنشطة التسلية والترفيه,متناهية الصغر,102,83,33,50,164,143,21
2023,1,منطقة المدينة المنورة,الأنشطة الرياضية وأنشطة التسلية والترفيه,متوسطة,2,85,37,48,124,113,11
2023,1,منطقة تبوك,الأنشطة الرياضية وأنشطة التسلية والترفيه,صغيرة,25,101,33,68,150,130,20
2023,1,منطقة تبوك,الأنشطة الرياضية وأنشطة التسلية والترفيه,متناهية الصغر,76,36,11,25,133,125,8
2023,1,منطقة جازان,الأنشطة الرياضية وأنشطة التسلية والترفيه,صغيرة,12,35,9,26,177,161,16
2023,1,منطقة جازان,الأنشطة الرياضية وأنشطة التسلية والترفيه,متناهية الصغر,69,43,14,29,102,88,14
2023,1,منطقة جازان,الأنشطة الرياضية وأنشطة التسلية والترفيه,متوسطة,3,33,18,15,195,195,0
2023,1,منطقة حائل,الأنشطة الرياضية وأنشطة التسلية والترفيه,صغيرة,23,85,35,50,203,201,2
2023,1,منطقة حائل,الأنشطة الرياضية وأنشطة التسلية والترفيه,متناهية الصغر,60,39,21,18,107,102,5
2023,1,منطقة عسير,الأنشطة الرياضية وأنشطة التسلية والترفيه,صغيرة,65,285,81,204,568,499,69
2023,1,منطقة عسير,الأنشطة الرياضية وأنشطة التسلية والترفيه,متناهية الصغر,145,88,35,53,249,236,13
2023,1,منطقة مكة المكرمة,الأنشطة الرياضية وأنشطة التسلية والترفيه,صغيرة,199,1023,384,639,1514,1293,221
2023,1,منطقة مكة المكرمة,الأنشطة الرياضية وأنشطة التسلية والترفيه,كبيرة,1,140,76,64,166,109,57
2023,1,منطقة مكة المكرمة,الأنشطة الرياضية وأنشطة التسلية والترفيه,متناهية الصغر,605,383,154,229,1064,966,98
2023,1,منطقة مكة المكرمة,الأنشطة الرياضية وأنشطة التسلية والترفيه,متوسطة,25,1257,490,767,1272,1147,125
2023,1,منطقة نجران,الأنشطة الرياضية وأنشطة التسلية والترفيه,صغيرة,16,68,38,30,117,113,4
2023,1,منطقة نجران,الأنشطة الرياضية وأنشطة التسلية والترفيه,متناهية الصغر,41,22,13,9,87,81,6
2023,1,المنطقة الشرقية,الأنشطة البيطرية,صغيرة,13,65,25,40,137,129,8
2023,1,المنطقة الشرقية,الأنشطة البيطرية,متناهية الصغر,50,30,15,15,84,77,7
2023,1,منطقة الباحة,الأنشطة البيطرية,متناهية الصغر,2,1,0,1,2,2,0
2023,1,منطقة الجوف,الأنشطة البيطرية,متناهية الصغر,1,0,0,0,3,3,0
2023,1,منطقة الحدود الشمالية,الأنشطة البيطرية,متناهية الصغر,5,3,2,1,10,10,0
2023,1,منطقة الرياض,الأنشطة البيطرية,صغيرة,35,161,65,96,324,283,41
2023,1,منطقة الرياض,الأنشطة البيطرية,متناهية الصغر,83,50,17,33,144,138,6
2023,1,منطقة الرياض,الأنشطة البيطرية,متوسطة,3,89,40,49,124,115,9
2023,1,منطقة القصيم,الأنشطة البيطرية,صغيرة,3,11,9,2,10,10,0
2023,1,منطقة القصيم,الأنشطة البيطرية,متناهية الصغر,19,5,2,3,33,31,2
2023,1,منطقة القصيم,الأنشطة البيطرية,متوسطة,1,31,31,0,55,55,0
2023,1,منطقة المدينة المنورة,الأنشطة البيطرية,صغيرة,4,15,4,11,22,17,5
2023,1,منطقة المدينة المنورة,الأنشطة البيطرية,متناهية الصغر,17,2,1,1,31,30,1
2023,1,منطقة تبوك,الأنشطة البيطرية,صغيرة,2,7,1,6,17,16,1
2023,1,منطقة تبوك,الأنشطة البيطرية,متناهية الصغر,8,7,6,1,14,14,0
2023,1,منطقة جازان,الأنشطة البيطرية,متناهية الصغر,7,4,2,2,14,14,0
2023,1,منطقة حائل,الأنشطة البيطرية,صغيرة,1,1,0,1,6,6,0
2023,1,منطقة حائل,الأنشطة البيطرية,متناهية الصغر,7,0,0,0,14,13,1
2023,1,منطقة عسير,الأنشطة البيطرية,صغيرة,3,7,5,2,27,24,3
2023,1,منطقة عسير,الأنشطة البيطرية,متناهية الصغر,33,6,2,4,54,53,1
2023,1,منطقة مكة المكرمة,الأنشطة البيطرية,صغيرة,20,98,23,75,181,156,25
2023,1,منطقة مكة المكرمة,الأنشطة البيطرية,متناهية الصغر,56,23,8,15,101,96,5
2023,1,منطقة مكة المكرمة,الأنشطة البيطرية,متوسطة,1,19,6,13,45,38,7
2023,1,منطقة نجران,الأنشطة البيطرية,متناهية الصغر,11,2,1,1,17,17,0
2023,1,المنطقة الشرقية,الأنشطة الإيجارية,صغيرة,321,1097,704,393,3557,3545,12
2023,1,المنطقة الشرقية,الأنشطة الإيجارية,كبيرة,10,1204,794,410,2867,2864,3
2023,1,المنطقة الشرقية,الأنشطة الإيجارية,متناهية الصغر,1964,424,226,198,4123,4108,15
2023,1,المنطقة الشرقية,الأنشطة الإيجارية,متوسطة,39,890,651,239,2935,2929,6
2023,1,منطقة الباحة,الأنشطة الإيجارية,صغيرة,7,6,2,4,47,47,0
2023,1,منطقة الباحة,الأنشطة الإيجارية,متناهية الصغر,144,15,13,2,280,278,2
2023,1,منطقة الجوف,الأنشطة الإيجارية,صغيرة,25,22,18,4,204,204,0
2023,1,منطقة الجوف,الأنشطة الإيجارية,متناهية الصغر,603,38,23,15,1205,1194,11
2023,1,منطقة الحدود الشمالية,الأنشطة الإيجارية,صغيرة,9,32,23,9,92,92,0
2023,1,منطقة الحدود الشمالية,الأنشطة الإيجارية,متناهية الصغر,199,20,18,2,415,411,4
2023,1,منطقة الرياض,الأنشطة الإيجارية,صغيرة,1012,1460,829,631,7985,7930,55
2023,1,منطقة الرياض,الأنشطة الإيجارية,كبيرة,6,1615,1339,276,2482,2479,3
2023,1,منطقة الرياض,الأنشطة الإيجارية,متناهية الصغر,48937,2682,1289,1393,124732,124158,574
2023,1,منطقة الرياض,الأنشطة الإيجارية,متوسطة,40,1655,1178,477,2856,2846,10
2023,1,منطقة القصيم,الأنشطة الإيجارية,صغيرة,65,142,97,45,511,510,1
2023,1,منطقة القصيم,الأنشطة الإيجارية,كبيرة,1,73,62,11,278,278,0
2023,1,منطقة القصيم,الأنشطة الإيجارية,متناهية الصغر,1141,154,97,57,2612,2591,21
2023,1,منطقة القصيم,الأنشطة الإيجارية,متوسطة,4,158,124,34,473,473,0
2023,1,منطقة المدينة المنورة,الأنشطة الإيجارية,صغيرة,76,264,174,90,772,771,1
2023,1,منطقة المدينة المنورة,الأنشطة الإيجارية,متناهية الصغر,986,133,80,53,2016,2004,12
2023,1,منطقة المدينة المنورة,الأنشطة الإيجارية,متوسطة,4,151,144,7,381,381,0
2023,1,منطقة تبوك,الأنشطة الإيجارية,صغيرة,17,75,66,9,155,155,0
2023,1,منطقة تبوك,الأنشطة الإيجارية,متناهية الصغر,424,52,26,26,776,773,3
2023,1,منطقة تبوك,الأنشطة الإيجارية,متوسطة,4,74,57,17,206,206,0
2023,1,منطقة جازان,الأنشطة الإيجارية,صغيرة,22,45,34,11,235,226,9
2023,1,منطقة جازان,الأنشطة الإيجارية,متناهية الصغر,1130,73,40,33,2560,2552,8
2023,1,منطقة جازان,الأنشطة الإيجارية,متوسطة,1,37,37,0,28,28,0
2023,1,منطقة حائل,الأنشطة الإيجارية,صغيرة,43,42,30,12,304,302,2
2023,1,منطقة حائل,الأنشطة الإيجارية,متناهية الصغر,905,59,26,33,2339,2322,17
2023,1,منطقة حائل,الأنشطة الإيجارية,متوسطة,1,0,0,0,69,69,0
2023,1,منطقة عسير,الأنشطة الإيجارية,صغيرة,64,176,117,59,506,502,4
2023,1,منطقة عسير,الأنشطة الإيجارية,متناهية الصغر,1394,148,84,64,2774,2767,7
2023,1,منطقة عسير,الأنشطة الإيجارية,متوسطة,1,59,59,0,61,60,1
2023,1,منطقة مكة المكرمة,الأنشطة الإيجارية,صغيرة,219,858,589,269,2121,2099,22
2023,1,منطقة مكة المكرمة,الأنشطة الإيجارية,كبيرة,5,596,398,198,1502,1500,2
2023,1,منطقة مكة المكرمة,الأنشطة الإيجارية,متناهية الصغر,3187,417,235,182,6850,6759,91
2023,1,منطقة مكة المكرمة,الأنشطة الإيجارية,متوسطة,23,756,633,123,1265,1263,2
2023,1,منطقة نجران,الأنشطة الإيجارية,صغيرة,40,40,23,17,347,347,0
2023,1,منطقة نجران,الأنشطة الإيجارية,متناهية الصغر,1234,62,31,31,2987,2971,16
2023,1,المنطقة الشرقية,أنشطة المكاتب,صغيرة,136,766,367,399,1077,1049,28
2023,1,المنطقة الشرقية,أنشطة المكاتب,كبيرة,2,659,501,158,803,803,0
2023,1,المنطقة الشرقية,أنشطة المكاتب,متناهية الصغر,788,416,186,230,1353,1320,33
2023,1,المنطقة الشرقية,أنشطة المكاتب,متوسطة,14,707,512,195,963,948,15
2023,1,منطقة الباحة,أنشطة المكاتب,صغيرة,6,21,20,1,32,32,0
2023,1,منطقة الباحة,أنشطة المكاتب,متناهية الصغر,43,16,10,6,75,75,0
2023,1,منطقة الجوف,أنشطة المكاتب,صغيرة,5,9,4,5,35,35,0
2023,1,منطقة الجوف,أنشطة المكاتب,متناهية الصغر,88,22,12,10,175,171,4
2023,1,منطقة الحدود الشمالية,أنشطة المكاتب,صغيرة,3,5,0,5,18,18,0
2023,1,منطقة الحدود الشمالية,أنشطة المكاتب,متناهية الصغر,50,9,5,4,99,99,0
2023,1,منطقة الرياض,أنشطة المكاتب,صغيرة,542,3306,1403,1903,4338,4040,298
2023,1,منطقة الرياض,أنشطة المكاتب,كبيرة,12,4894,2658,2236,3012,2739,273
2023,1,منطقة الرياض,أنشطة المكاتب,متناهية الصغر,2317,1300,606,694,3941,3799,142
2023,1,منطقة الرياض,أنشطة المكاتب,متوسطة,47,2182,1003,1179,2178,2014,164
2023,1,منطقة القصيم,أنشطة المكاتب,صغيرة,18,70,37,33,237,237,0
2023,1,منطقة القصيم,أنشطة المكاتب,متناهية الصغر,238,78,48,30,403,402,1
2023,1,منطقة القصيم,أنشطة المكاتب,متوسطة,1,0,0,0,55,54,1
2023,1,منطقة المدينة المنورة,أنشطة المكاتب,صغيرة,33,171,105,66,250,244,6
2023,1,منطقة المدينة المنورة,أنشطة المكاتب,متناهية الصغر,318,108,56,52,571,541,30
2023,1,منطقة المدينة المنورة,أنشطة المكاتب,متوسطة,1,70,47,23,116,98,18
2023,1,منطقة تبوك,أنشطة المكاتب,صغيرة,10,46,25,21,73,63,10
2023,1,منطقة تبوك,أنشطة المكاتب,متناهية الصغر,156,41,12,29,262,259,3
2023,1,منطقة تبوك,أنشطة المكاتب,متوسطة,1,26,15,11,33,27,6
2023,1,منطقة جازان,أنشطة المكاتب,صغيرة,5,17,9,8,34,34,0
2023,1,منطقة جازان,أنشطة المكاتب,متناهية الصغر,138,34,13,21,269,265,4
2023,1,منطقة حائل,أنشطة المكاتب,صغيرة,5,24,9,15,44,44,0
2023,1,منطقة حائل,أنشطة المكاتب,متناهية الصغر,186,38,15,23,337,329,8
2023,1,منطقة عسير,أنشطة المكاتب,صغيرة,20,57,32,25,125,123,2
2023,1,منطقة عسير,أنشطة المكاتب,متناهية الصغر,305,85,47,38,545,543,2
2023,1,منطقة عسير,أنشطة المكاتب,متوسطة,1,25,18,7,30,30,0
2023,1,منطقة مكة المكرمة,أنشطة المكاتب,صغيرة,293,1485,692,793,2329,2172,157
2023,1,منطقة مكة المكرمة,أنشطة المكاتب,كبيرة,5,3053,1928,1125,1138,1078,60
2023,1,منطقة مكة المكرمة,أنشطة المكاتب,متناهية الصغر,1546,666,312,354,2803,2660,143
2023,1,منطقة مكة المكرمة,أنشطة المكاتب,متوسطة,27,1164,702,462,1314,1256,58
2023,1,منطقة نجران,أنشطة المكاتب,صغيرة,3,6,3,3,13,13,0
2023,1,منطقة نجران,أنشطة المكاتب,متناهية الصغر,104,25,11,14,185,185,0
2023,1,المنطقة الشرقية,التعدين,صغيرة,56,188,105,83,829,828,1
2023,1,المنطقة الشرقية,التعدين,كبيرة,3,1030,946,84,2199,2199,0
2023,1,المنطقة الشرقية,التعدين,متناهية الصغر,96,71,46,25,172,171,1
2023,1,المنطقة الشرقية,التعدين,متوسطة,11,346,224,122,683,680,3
2023,1,منطقة الباحة,التعدين,صغيرة,3,11,2,9,39,39,0
2023,1,منطقة الباحة,التعدين,متناهية الصغر,7,6,4,2,12,12,0
2023,1,منطقة الجوف,التعدين,صغيرة,2,12,9,3,55,55,0
2023,1,منطقة الجوف,التعدين,متناهية الصغر,12,8,7,1,21,21,0
2023,1,منطقة الحدود الشمالية,التعدين,صغيرة,3,7,5,2,19,19,0
2023,1,منطقة الحدود الشمالية,التعدين,متناهية الصغر,7,3,2,1,22,22,0
2023,1,منطقة الحدود الشمالية,التعدين,متوسطة,2,125,115,10,119,119,0
2023,1,منطقة الرياض,التعدين,صغيرة,151,553,303,250,1898,1893,5
2023,1,منطقة الرياض,التعدين,كبيرة,6,380,292,88,1822,1822,0
2023,1,منطقة الرياض,التعدين,متناهية الصغر,295,196,114,82,539,536,3
2023,1,منطقة الرياض,التعدين,متوسطة,28,746,390,356,1834,1831,3
2023,1,منطقة القصيم,التعدين,صغيرة,9,53,37,16,109,109,0
2023,1,منطقة القصيم,التعدين,متناهية الصغر,29,15,15,0,52,52,0
2023,1,منطقة القصيم,التعدين,متوسطة,3,49,22,27,252,252,0
2023,1,منطقة المدينة المنورة,التعدين,صغيرة,28,129,91,38,411,411,0
2023,1,منطقة المدينة المنورة,التعدين,كبيرة,3,351,313,38,649,647,2
2023,1,منطقة المدينة المنورة,التعدين,متناهية الصغر,53,38,24,14,92,92,0
2023,1,منطقة المدينة المنورة,التعدين,متوسطة,1,23,23,0,48,48,0
2023,1,منطقة تبوك,التعدين,صغيرة,8,38,22,16,70,70,0
2023,1,منطقة تبوك,التعدين,متناهية الصغر,14,8,3,5,17,17,0
2023,1,منطقة تبوك,التعدين,متوسطة,1,14,8,6,85,85,0
2023,1,منطقة جازان,التعدين,صغيرة,19,73,42,31,254,254,0
2023,1,منطقة جازان,التعدين,متناهية الصغر,29,19,7,12,48,47,1
2023,1,منطقة جازان,التعدين,متوسطة,1,32,10,22,70,70,0
2023,1,منطقة حائل,التعدين,صغيرة,1,1,0,1,9,9,0
2023,1,منطقة حائل,التعدين,متناهية الصغر,11,3,1,2,14,14,0
2023,1,منطقة عسير,التعدين,صغيرة,22,69,45,24,243,243,0
2023,1,منطقة عسير,التعدين,متناهية الصغر,61,34,24,10,115,113,2
2023,1,منطقة عسير,التعدين,متوسطة,2,27,23,4,124,124,0
2023,1,منطقة مكة المكرمة,التعدين,صغيرة,74,256,131,125,831,828,3
2023,1,منطقة مكة المكرمة,التعدين,كبيرة,1,163,148,15,110,110,0
2023,1,منطقة مكة المكرمة,التعدين,متناهية الصغر,140,90,49,41,245,244,1
2023,1,منطقة مكة المكرمة,التعدين,متوسطة,10,275,204,71,784,783,1
2023,1,منطقة نجران,التعدين,صغيرة,8,26,16,10,133,133,0
2023,1,منطقة نجران,التعدين,متناهية الصغر,15,7,4,3,33,32,1
2023,1,المنطقة الشرقية,الأنشطة الإبداعية والفنون وأنشطة الترفيه,صغيرة,2,9,5,4,17,17,0
2023,1,المنطقة الشرقية,الأنشطة الإبداعية والفنون وأنشطة الترفيه,متناهية الصغر,30,21,6,15,43,38,5
2023,1,منطقة الباحة,الأنشطة الإبداعية والفنون وأنشطة الترفيه,متناهية الصغر,2,2,0,2,4,4,0
2023,1,منطقة الحدود الشمالية,الأنشطة الإبداعية والفنون وأنشطة الترفيه,متناهية الصغر,1,0,0,0,2,2,0
2023,1,منطقة الرياض,الأنشطة الإبداعية والفنون وأنشطة الترفيه,صغيرة,13,75,28,47,87,74,13
2023,1,منطقة الرياض,الأنشطة الإبداعية والفنون وأنشطة الترفيه,كبيرة,2,231,171,60,319,316,3
2023,1,منطقة الرياض,الأنشطة الإبداعية والفنون وأنشطة الترفيه,متناهية الصغر,100,61,31,30,144,127,17
2023,1,منطقة الرياض,الأنشطة الإبداعية والفنون وأنشطة الترفيه,متوسطة,2,56,27,29,166,164,2
2023,1,منطقة القصيم,الأنشطة الإبداعية والفنون وأنشطة الترفيه,متناهية الصغر,6,4,2,2,12,12,0
2023,1,منطقة المدينة المنورة,الأنشطة الإبداعية والفنون وأنشطة الترفيه,صغيرة,1,1,0,1,6,6,0
2023,1,منطقة المدينة المنورة,الأنشطة الإبداعية والفنون وأنشطة الترفيه,متناهية الصغر,13,3,2,1,21,19,2
2023,1,منطقة تبوك,الأنشطة الإبداعية والفنون وأنشطة الترفيه,متناهية الصغر,3,0,0,0,6,6,0
2023,1,منطقة جازان,الأنشطة الإبداعية والفنون وأنشطة الترفيه,متناهية الصغر,2,1,1,0,3,2,1
2023,1,منطقة حائل,الأنشطة الإبداعية والفنون وأنشطة الترفيه,متناهية الصغر,2,1,1,0,2,2,0
2023,1,منطقة عسير,الأنشطة الإبداعية والفنون وأنشطة الترفيه,صغيرة,2,3,3,0,10,10,0
2023,1,منطقة عسير,الأنشطة الإبداعية والفنون وأنشطة الترفيه,متناهية الصغر,12,1,1,0,26,26,0
2023,1,منطقة عسير,الأنشطة الإبداعية والفنون وأنشطة الترفيه,متوسطة,1,24,5,19,29,29,0
2023,1,منطقة مكة المكرمة,الأنشطة الإبداعية والفنون وأنشطة الترفيه,صغيرة,6,26,8,18,49,47,2
2023,1,منطقة مكة المكرمة,الأنشطة الإبداعية والفنون وأنشطة الترفيه,متناهية الصغر,104,71,27,44,155,135,20
2023,1,منطقة نجران,الأنشطة الإبداعية والفنون وأنشطة الترفيه,متناهية الصغر,2,0,0,0,5,5,0
2023,1,المنطقة الشرقية,الإقامة,صغيرة,270,1327,711,616,2507,2486,21
2023,1,المنطقة الشرقية,الإقامة,كبيرة,1,95,68,27,168,168,0
2023,1,المنطقة الشرقية,الإقامة,متناهية الصغر,324,268,137,131,595,583,12
2023,1,المنطقة الشرقية,الإقامة,متوسطة,35,1285,722,563,1961,1886,75
2023,1,منطقة الباحة,الإقامة,صغيرة,21,79,50,29,169,169,0
2023,1,منطقة الباحة,الإقامة,متناهية الصغر,79,47,33,14,129,128,1
2023,1,منطقة الباحة,الإقامة,متوسطة,1,25,13,12,41,41,0
2023,1,منطقة الجوف,الإقامة,صغيرة,9,33,16,17,88,88,0
2023,1,منطقة الجوف,الإقامة,متناهية الصغر,64,40,21,19,114,113,1
2023,1,منطقة الحدود الشمالية,الإقامة,صغيرة,12,49,23,26,101,101,0
2023,1,منطقة الحدود الشمالية,الإقامة,متناهية الصغر,36,18,14,4,77,77,0
2023,1,منطقة الحدود الشمالية,الإقامة,متوسطة,1,18,9,9,38,38,0
2023,1,منطقة الرياض,الإقامة,صغيرة,413,2146,1133,1013,4157,4098,59
2023,1,منطقة الرياض,الإقامة,كبيرة,7,1151,773,378,1562,1472,90
2023,1,منطقة الرياض,الإقامة,متناهية الصغر,746,517,249,268,1478,1456,22
2023,1,منطقة الرياض,الإقامة,متوسطة,80,2996,1773,1223,4394,4309,85
2023,1,منطقة القصيم,الإقامة,صغيرة,52,226,143,83,417,417,0
2023,1,منطقة القصيم,الإقامة,كبيرة,1,0,0,0,319,314,5
2023,1,منطقة القصيم,الإقامة,متناهية الصغر,109,79,54,25,224,224,0
2023,1,منطقة القصيم,الإقامة,متوسطة,4,107,71,36,169,169,0
2023,1,منطقة المدينة المنورة,الإقامة,صغيرة,206,1222,830,392,1757,1740,17
2023,1,منطقة المدينة المنورة,الإقامة,كبيرة,4,580,387,193,777,769,8
2023,1,منطقة المدينة المنورة,الإقامة,متناهية الصغر,397,256,180,76,698,682,16
2023,1,منطقة المدينة المنورة,الإقامة,متوسطة,39,1610,1118,492,2070,2043,27
2023,1,منطقة تبوك,الإقامة,صغيرة,41,217,116,101,360,360,0
2023,1,منطقة تبوك,الإقامة,متناهية الصغر,104,77,41,36,196,194,2
2023,1,منطقة تبوك,الإقامة,متوسطة,5,191,106,85,334,319,15
2023,1,منطقة جازان,الإقامة,صغيرة,50,201,99,102,414,384,30
2023,1,منطقة جازان,الإقامة,متناهية الصغر,263,123,49,74,449,447,2
2023,1,منطقة جازان,الإقامة,متوسطة,5,134,59,75,343,339,4
2023,1,منطقة حائل,الإقامة,صغيرة,24,90,67,23,176,175,1
2023,1,منطقة حائل,الإقامة,متناهية الصغر,67,47,28,19,130,130,0
2023,1,منطقة حائل,الإقامة,متوسطة,1,19,14,5,44,44,0
2023,1,منطقة عسير,الإقامة,صغيرة,118,413,209,204,829,824,5
2023,1,منطقة عسير,الإقامة,متناهية الصغر,407,267,145,122,794,782,12
2023,1,منطقة عسير,الإقامة,متوسطة,5,145,86,59,268,265,3
2023,1,منطقة مكة المكرمة,الإقامة,صغيرة,619,2945,1791,1154,5346,5216,130
2023,1,منطقة مكة المكرمة,الإقامة,كبيرة,15,2180,1511,669,2850,2817,33
2023,1,منطقة مكة المكرمة,الإقامة,متناهية الصغر,1202,842,528,314,2125,2077,48
2023,1,منطقة مكة المكرمة,الإقامة,متوسطة,87,3781,2423,1358,5093,4911,182
2023,1,منطقة نجران,الإقامة,صغيرة,21,79,34,45,172,170,2
2023,1,منطقة نجران,الإقامة,متناهية الصغر,106,43,23,20,236,234,2
2023,1,منطقة نجران,الإقامة,متوسطة,1,25,9,16,34,32,2
2023,1,المنطقة الشرقية,الإدارة العامة والدفاع ؛ والضمان الاجتماعي الإلزامي,صغيرة,17,237,172,65,137,133,4
2023,1,المنطقة الشرقية,الإدارة العامة والدفاع ؛ والضمان الاجتماعي الإلزامي,كبيرة,2,801,639,162,220,216,4
2023,1,المنطقة الشرقية,الإدارة العامة والدفاع ؛ والضمان الاجتماعي الإلزامي,متناهية الصغر,82,47,26,21,115,115,0
2023,1,المنطقة الشرقية,الإدارة العامة والدفاع ؛ والضمان الاجتماعي الإلزامي,متوسطة,1,30,29,1,34,34,0
2023,1,منطقة الباحة,الإدارة العامة والدفاع ؛ والضمان الاجتماعي الإلزامي,صغيرة,1,8,4,4,1,1,0
2023,1,منطقة الباحة,الإدارة العامة والدفاع ؛ والضمان الاجتماعي الإلزامي,متناهية الصغر,8,0,0,0,21,21,0
2023,1,منطقة الجوف,الإدارة العامة والدفاع ؛ والضمان الاجتماعي الإلزامي,متناهية الصغر,7,1,0,1,16,15,1
2023,1,منطقة الحدود الشمالية,الإدارة العامة والدفاع ؛ والضمان الاجتماعي الإلزامي,متناهية الصغر,3,0,0,0,10,10,0
2023,1,منطقة الرياض,الإدارة العامة والدفاع ؛ والضمان الاجتماعي الإلزامي,صغيرة,42,339,168,171,374,337,37
2023,1,منطقة الرياض,الإدارة العامة والدفاع ؛ والضمان الاجتماعي الإلزامي,كبيرة,2,1222,793,429,187,176,11
2023,1,منطقة الرياض,الإدارة العامة والدفاع ؛ والضمان الاجتماعي الإلزامي,متناهية الصغر,197,93,49,44,318,308,10
2023,1,منطقة الرياض,الإدارة العامة والدفاع ؛ والضمان الاجتماعي الإلزامي,متوسطة,3,250,199,51,76,70,6
2023,1,منطقة القصيم,الإدارة العامة والدفاع ؛ والضمان الاجتماعي الإلزامي,صغيرة,4,63,23,40,36,32,4
2023,1,منطقة القصيم,الإدارة العامة والدفاع ؛ والضمان الاجتماعي الإلزامي,متناهية الصغر,23,5,5,0,53,51,2
2023,1,منطقة المدينة المنورة,الإدارة العامة والدفاع ؛ والضمان الاجتماعي الإلزامي,صغيرة,2,18,15,3,7,7,0
2023,1,منطقة المدينة المنورة,الإدارة العامة والدفاع ؛ والضمان الاجتماعي الإلزامي,متناهية الصغر,32,11,6,5,72,71,1
2023,1,منطقة تبوك,الإدارة العامة والدفاع ؛ والضمان الاجتماعي الإلزامي,صغيرة,3,52,23,29,22,21,1
2023,1,منطقة تبوك,الإدارة العامة والدفاع ؛ والضمان الاجتماعي الإلزامي,متناهية الصغر,13,0,0,0,33,32,1
2023,1,منطقة جازان,الإدارة العامة والدفاع ؛ والضمان الاجتماعي الإلزامي,صغيرة,1,2,0,2,4,1,3
2023,1,منطقة جازان,الإدارة العامة والدفاع ؛ والضمان الاجتماعي الإلزامي,متناهية الصغر,35,4,2,2,105,105,0
2023,1,منطقة حائل,الإدارة العامة والدفاع ؛ والضمان الاجتماعي الإلزامي,متناهية الصغر,10,7,5,2,16,16,0
2023,1,منطقة عسير,الإدارة العامة والدفاع ؛ والضمان الاجتماعي الإلزامي,صغيرة,2,5,2,3,12,12,0
2023,1,منطقة عسير,الإدارة العامة والدفاع ؛ والضمان الاجتماعي الإلزامي,متناهية الصغر,21,3,2,1,55,55,0
2023,1,منطقة مكة المكرمة,الإدارة العامة والدفاع ؛ والضمان الاجتماعي الإلزامي,صغيرة,34,199,115,84,234,226,8
2023,1,منطقة مكة المكرمة,الإدارة العامة والدفاع ؛ والضمان الاجتماعي الإلزامي,متناهية الصغر,207,84,55,29,343,334,9
2023,1,منطقة مكة المكرمة,الإدارة العامة والدفاع ؛ والضمان الاجتماعي الإلزامي,متوسطة,2,330,174,156,92,88,4
2023,1,منطقة نجران,الإدارة العامة والدفاع ؛ والضمان الاجتماعي الإلزامي,متناهية الصغر,15,1,1,0,28,28,0
2023,1,المنطقة الشرقية,الاتصالات,صغيرة,27,201,142,59,245,240,5
2023,1,المنطقة الشرقية,الاتصالات,متناهية الصغر,98,61,35,26,157,155,2
2023,1,المنطقة الشرقية,الاتصالات,متوسطة,2,91,84,7,50,50,0
2023,1,منطقة الباحة,الاتصالات,صغيرة,1,3,1,2,6,6,0
2023,1,منطقة الباحة,الاتصالات,متناهية الصغر,3,3,3,0,3,3,0
2023,1,منطقة الجوف,الاتصالات,متناهية الصغر,15,7,3,4,22,22,0
2023,1,منطقة الحدود الشمالية,الاتصالات,متناهية الصغر,13,4,0,4,28,27,1
2023,1,منطقة الرياض,الاتصالات,صغيرة,128,863,386,477,1365,1300,65
2023,1,منطقة الرياض,الاتصالات,كبيرة,12,19729,15214,4515,2735,2679,56
2023,1,منطقة الرياض,الاتصالات,متناهية الصغر,348,190,106,84,641,633,8
2023,1,منطقة الرياض,الاتصالات,متوسطة,30,2045,1330,715,1265,1229,36
2023,1,منطقة القصيم,الاتصالات,صغيرة,5,28,10,18,51,51,0
2023,1,منطقة القصيم,الاتصالات,متناهية الصغر,57,16,10,6,106,106,0
2023,1,منطقة المدينة المنورة,الاتصالات,صغيرة,3,16,5,11,6,6,0
2023,1,منطقة المدينة المنورة,الاتصالات,متناهية الصغر,31,11,8,3,57,57,0
2023,1,منطقة تبوك,الاتصالات,صغيرة,1,2,1,1,5,5,0
2023,1,منطقة تبوك,الاتصالات,متناهية الصغر,16,6,4,2,19,19,0
2023,1,منطقة جازان,الاتصالات,صغيرة,2,2,2,0,12,12,0
2023,1,منطقة جازان,الاتصالات,متناهية الصغر,21,4,3,1,36,36,0
2023,1,منطقة حائل,الاتصالات,صغيرة,1,0,0,0,9,9,0
2023,1,منطقة حائل,الاتصالات,متناهية الصغر,17,9,2,7,30,28,2
2023,1,منطقة عسير,الاتصالات,صغيرة,3,6,4,2,14,14,0
2023,1,منطقة عسير,الاتصالات,متناهية الصغر,43,17,12,5,68,67,1
2023,1,منطقة مكة المكرمة,الاتصالات,صغيرة,31,235,102,133,292,282,10
2023,1,منطقة مكة المكرمة,الاتصالات,متناهية الصغر,236,82,47,35,397,391,6
2023,1,منطقة مكة المكرمة,الاتصالات,متوسطة,1,73,71,2,29,29,0
2023,1,منطقة نجران,الاتصالات,صغيرة,1,0,0,0,11,11,0
2023,1,منطقة نجران,الاتصالات,متناهية الصغر,11,1,1,0,25,25,0
2023,1,المنطقة الشرقية,إصلاح وتركيب الآلات والمعدات,صغيرة,308,1159,787,372,3379,3372,7
2023,1,المنطقة الشرقية,إصلاح وتركيب الآلات والمعدات,كبيرة,18,3090,2456,634,7467,7452,15
2023,1,المنطقة الشرقية,إصلاح وتركيب الآلات والمعدات,متناهية الصغر,918,333,178,155,1997,1994,3
2023,1,المنطقة الشرقية,إصلاح وتركيب الآلات والمعدات,متوسطة,70,2379,1709,670,4905,4899,6
2023,1,منطقة الباحة,إصلاح وتركيب الآلات والمعدات,صغيرة,2,2,1,1,14,14,0
2023,1,منطقة الباحة,إصلاح وتركيب الآلات والمعدات,متناهية الصغر,53,7,6,1,90,90,0
2023,1,منطقة الجوف,إصلاح وتركيب الآلات والمعدات,صغيرة,7,12,8,4,41,41,0
2023,1,منطقة الجوف,إصلاح وتركيب الآلات والمعدات,متناهية الصغر,70,9,6,3,156,154,2
2023,1,منطقة الحدود الشمالية,إصلاح وتركيب الآلات والمعدات,صغيرة,1,0,0,0,7,7,0
2023,1,منطقة الحدود الشمالية,إصلاح وتركيب الآلات والمعدات,متناهية الصغر,68,4,3,1,177,177,0
2023,1,منطقة الحدود الشمالية,إصلاح وتركيب الآلات والمعدات,متوسطة,2,54,50,4,175,175,0
2023,1,منطقة الرياض,إصلاح وتركيب الآلات والمعدات,صغيرة,284,1156,671,485,3390,3369,21
2023,1,منطقة الرياض,إصلاح وتركيب الآلات والمعدات,كبيرة,18,5905,5086,819,7137,7006,131
2023,1,منطقة الرياض,إصلاح وتركيب الآلات والمعدات,متناهية الصغر,1207,296,152,144,2842,2824,18
2023,1,منطقة الرياض,إصلاح وتركيب الآلات والمعدات,متوسطة,80,2761,2036,725,5863,5763,100
2023,1,منطقة القصيم,إصلاح وتركيب الآلات والمعدات,صغيرة,39,95,46,49,425,424,1
2023,1,منطقة القصيم,إصلاح وتركيب الآلات والمعدات,متناهية الصغر,234,26,19,7,565,564,1
2023,1,منطقة القصيم,إصلاح وتركيب الآلات والمعدات,متوسطة,5,104,93,11,418,418,0
2023,1,منطقة المدينة المنورة,إصلاح وتركيب الآلات والمعدات,صغيرة,27,135,104,31,265,265,0
2023,1,منطقة المدينة المنورة,إصلاح وتركيب الآلات والمعدات,متناهية الصغر,304,49,23,26,630,628,2
2023,1,منطقة المدينة المنورة,إصلاح وتركيب الآلات والمعدات,متوسطة,2,32,19,13,95,95,0
2023,1,منطقة تبوك,إصلاح وتركيب الآلات والمعدات,صغيرة,5,13,9,4,29,29,0
2023,1,منطقة تبوك,إصلاح وتركيب الآلات والمعدات,متناهية الصغر,136,15,9,6,301,299,2
2023,1,منطقة تبوك,إصلاح وتركيب الآلات والمعدات,متوسطة,1,34,34,0,21,21,0
2023,1,منطقة جازان,إصلاح وتركيب الآلات والمعدات,صغيرة,7,13,5,8,60,60,0
2023,1,منطقة جازان,إصلاح وتركيب الآلات والمعدات,متناهية الصغر,359,33,22,11,877,876,1
2023,1,منطقة جازان,إصلاح وتركيب الآلات والمعدات,متوسطة,1,26,6,20,135,135,0
2023,1,منطقة حائل,إصلاح وتركيب الآلات والمعدات,صغيرة,3,5,1,4,54,54,0
2023,1,منطقة حائل,إصلاح وتركيب الآلات والمعدات,متناهية الصغر,81,13,7,6,181,181,0
2023,1,منطقة عسير,إصلاح وتركيب الآلات والمعدات,صغيرة,14,29,20,9,131,131,0
2023,1,منطقة عسير,إصلاح وتركيب الآلات والمعدات,كبيرة,1,74,46,28,384,384,0
2023,1,منطقة عسير,إصلاح وتركيب الآلات والمعدات,متناهية الصغر,234,30,12,18,510,508,2
2023,1,منطقة عسير,إصلاح وتركيب الآلات والمعدات,متوسطة,1,11,10,1,48,48,0
2023,1,منطقة مكة المكرمة,إصلاح وتركيب الآلات والمعدات,صغيرة,160,617,314,303,1830,1811,19
2023,1,منطقة مكة المكرمة,إصلاح وتركيب الآلات والمعدات,كبيرة,3,4194,3405,789,1620,1620,0
2023,1,منطقة مكة المكرمة,إصلاح وتركيب الآلات والمعدات,متناهية الصغر,1063,202,96,106,2466,2445,21
2023,1,منطقة مكة المكرمة,إصلاح وتركيب الآلات والمعدات,متوسطة,32,1149,895,254,2476,2467,9
2023,1,منطقة نجران,إصلاح وتركيب الآلات والمعدات,صغيرة,2,7,4,3,29,29,0
2023,1,منطقة نجران,إصلاح وتركيب الآلات والمعدات,متناهية الصغر,59,10,6,4,155,155,0
2023,1,منطقة نجران,إصلاح وتركيب الآلات والمعدات,متوسطة,1,21,13,8,51,50,1
2023,1,المنطقة الشرقية,إصلاح أجهزة الحاسوب والسلع الشخصية والمنزلية,صغيرة,94,159,99,60,895,875,20
2023,1,المنطقة الشرقية,إصلاح أجهزة الحاسوب والسلع الشخصية والمنزلية,كبيرة,3,88,6,82,893,893,0
2023,1,المنطقة الشرقية,إصلاح أجهزة الحاسوب والسلع الشخصية والمنزلية,متناهية الصغر,901,178,106,72,1930,1926,4
2023,1,المنطقة الشرقية,إصلاح أجهزة الحاسوب والسلع الشخصية والمنزلية,متوسطة,13,374,305,69,1099,1099,0
2023,1,منطقة الباحة,إصلاح أجهزة الحاسوب والسلع الشخصية والمنزلية,صغيرة,2,1,1,0,12,12,0
2023,1,منطقة الباحة,إصلاح أجهزة الحاسوب والسلع الشخصية والمنزلية,متناهية الصغر,73,12,11,1,141,141,0
2023,1,منطقة الجوف,إصلاح أجهزة الحاسوب والسلع الشخصية والمنزلية,صغيرة,9,6,4,2,103,103,0
2023,1,منطقة الجوف,إصلاح أجهزة الحاسوب والسلع الشخصية والمنزلية,متناهية الصغر,150,14,9,5,333,333,0
2023,1,منطقة الحدود الشمالية,إصلاح أجهزة الحاسوب والسلع الشخصية والمنزلية,صغيرة,1,1,1,0,5,5,0
2023,1,منطقة الحدود الشمالية,إصلاح أجهزة الحاسوب والسلع الشخصية والمنزلية,متناهية الصغر,77,8,5,3,170,170,0
2023,1,منطقة الرياض,إصلاح أجهزة الحاسوب والسلع الشخصية والمنزلية,صغيرة,336,365,205,160,5233,5212,21
2023,1,منطقة الرياض,إصلاح أجهزة الحاسوب والسلع الشخصية والمنزلية,كبيرة,23,230,104,126,10935,10929,6
2023,1,منطقة الرياض,إصلاح أجهزة الحاسوب والسلع الشخصية والمنزلية,متناهية الصغر,1878,242,137,105,4149,4128,21
2023,1,منطقة الرياض,إصلاح أجهزة الحاسوب والسلع الشخصية والمنزلية,متوسطة,137,238,107,131,13849,13753,96
2023,1,منطقة القصيم,إصلاح أجهزة الحاسوب والسلع الشخصية والمنزلية,صغيرة,160,32,19,13,2431,2422,9
2023,1,منطقة القصيم,إصلاح أجهزة الحاسوب والسلع الشخصية والمنزلية,كبيرة,3,0,0,0,2686,2686,0
2023,1,منطقة القصيم,إصلاح أجهزة الحاسوب والسلع الشخصية والمنزلية,متناهية الصغر,659,69,47,22,1506,1504,2
2023,1,منطقة القصيم,إصلاح أجهزة الحاسوب والسلع الشخصية والمنزلية,متوسطة,25,26,26,0,2278,2271,7
2023,1,منطقة المدينة المنورة,إصلاح أجهزة الحاسوب والسلع الشخصية والمنزلية,صغيرة,18,17,7,10,168,165,3
2023,1,منطقة المدينة المنورة,إصلاح أجهزة الحاسوب والسلع الشخصية والمنزلية,متناهية الصغر,348,56,36,20,732,720,12
2023,1,منطقة تبوك,إصلاح أجهزة الحاسوب والسلع الشخصية والمنزلية,صغيرة,13,21,10,11,102,102,0
2023,1,منطقة تبوك,إصلاح أجهزة الحاسوب والسلع الشخصية والمنزلية,متناهية الصغر,263,31,24,7,567,564,3
2023,1,منطقة تبوك,إصلاح أجهزة الحاسوب والسلع الشخصية والمنزلية,متوسطة,2,0,0,0,131,131,0
2023,1,منطقة جازان,إصلاح أجهزة الحاسوب والسلع الشخصية والمنزلية,صغيرة,10,5,5,0,80,80,0
2023,1,منطقة جازان,إصلاح أجهزة الحاسوب والسلع الشخصية والمنزلية,متناهية الصغر,268,33,18,15,634,632,2
2023,1,منطقة حائل,إصلاح أجهزة الحاسوب والسلع الشخصية والمنزلية,صغيرة,18,27,6,21,167,167,0
2023,1,منطقة حائل,إصلاح أجهزة الحاسوب والسلع الشخصية والمنزلية,متناهية الصغر,302,30,21,9,707,704,3
2023,1,منطقة عسير,إصلاح أجهزة الحاسوب والسلع الشخصية والمنزلية,صغيرة,30,17,4,13,255,255,0
2023,1,منطقة عسير,إصلاح أجهزة الحاسوب والسلع الشخصية والمنزلية,متناهية الصغر,559,67,40,27,1278,1275,3
2023,1,منطقة مكة المكرمة,إصلاح أجهزة الحاسوب والسلع الشخصية والمنزلية,صغيرة,101,177,99,78,939,929,10
2023,1,منطقة مكة المكرمة,إصلاح أجهزة الحاسوب والسلع الشخصية والمنزلية,متناهية الصغر,1454,239,139,100,3305,3273,32
2023,1,منطقة مكة المكرمة,إصلاح أجهزة الحاسوب والسلع الشخصية والمنزلية,متوسطة,6,115,72,43,401,401,0
2023,1,منطقة نجران,إصلاح أجهزة الحاسوب والسلع الشخصية والمنزلية,صغيرة,43,9,3,6,612,610,2
2023,1,منطقة نجران,إصلاح أجهزة الحاسوب والسلع الشخصية والمنزلية,متناهية الصغر,213,18,7,11,494,493,1
2023,1,منطقة نجران,إصلاح أجهزة الحاسوب والسلع الشخصية والمنزلية,متوسطة,5,0,0,0,592,592,0
2023,1,المنطقة الشرقية,استخراج النفط الخام والغاز الطبيعي,صغيرة,16,121,97,24,221,221,0
2023,1,المنطقة الشرقية,استخراج النفط الخام والغاز الطبيعي,كبيرة,6,66311,62386,3925,7500,6872,628
2023,1,المنطقة الشرقية,استخراج النفط الخام والغاز الطبيعي,متناهية الصغر,31,29,17,12,47,46,1
2023,1,المنطقة الشرقية,استخراج النفط الخام والغاز الطبيعي,متوسطة,10,668,615,53,620,615,5
2023,1,منطقة الجوف,استخراج النفط الخام والغاز الطبيعي,متناهية الصغر,7,0,0,0,13,13,0
2023,1,منطقة الرياض,استخراج النفط الخام والغاز الطبيعي,صغيرة,9,5,4,1,104,104,0
2023,1,منطقة الرياض,استخراج النفط الخام والغاز الطبيعي,متناهية الصغر,18,8,4,4,28,28,0
2023,1,منطقة الرياض,استخراج النفط الخام والغاز الطبيعي,متوسطة,2,54,40,14,119,119,0
2023,1,منطقة القصيم,استخراج النفط الخام والغاز الطبيعي,متناهية الصغر,1,0,0,0,4,4,0
2023,1,منطقة المدينة المنورة,استخراج النفط الخام والغاز الطبيعي,متوسطة,1,76,76,0,33,33,0
2023,1,منطقة جازان,استخراج النفط الخام والغاز الطبيعي,متناهية الصغر,1,0,0,0,2,2,0
2023,1,منطقة عسير,استخراج النفط الخام والغاز الطبيعي,متناهية الصغر,3,1,0,1,4,4,0
2023,1,منطقة مكة المكرمة,استخراج النفط الخام والغاز الطبيعي,كبيرة,1,336,333,3,25,25,0
2023,1,منطقة مكة المكرمة,استخراج النفط الخام والغاز الطبيعي,متناهية الصغر,3,0,0,0,12,12,0
2023,1,منطقة نجران,استخراج النفط الخام والغاز الطبيعي,صغيرة,2,3,3,0,14,14,0
2023,1,منطقة نجران,استخراج النفط الخام والغاز الطبيعي,متناهية الصغر,6,2,2,0,10,9,1
2023,1,المنطقة الشرقية,أبحاث الإعلان والسوق,صغيرة,214,1006,423,583,1614,1589,25
2023,1,المنطقة الشرقية,أبحاث الإعلان والسوق,كبيرة,3,583,524,59,714,711,3
2023,1,المنطقة الشرقية,أبحاث الإعلان والسوق,متناهية الصغر,689,393,140,253,1294,1271,23
2023,1,المنطقة الشرقية,أبحاث الإعلان والسوق,متوسطة,7,392,101,291,324,319,5
2023,1,منطقة الباحة,أبحاث الإعلان والسوق,صغيرة,2,7,5,2,7,7,0
2023,1,منطقة الباحة,أبحاث الإعلان والسوق,متناهية الصغر,28,14,9,5,58,58,0
2023,1,منطقة الجوف,أبحاث الإعلان والسوق,صغيرة,5,7,5,2,30,30,0
2023,1,منطقة الجوف,أبحاث الإعلان والسوق,متناهية الصغر,72,12,7,5,164,161,3
2023,1,منطقة الحدود الشمالية,أبحاث الإعلان والسوق,صغيرة,3,17,7,10,26,26,0
2023,1,منطقة الحدود الشمالية,أبحاث الإعلان والسوق,متناهية الصغر,29,7,1,6,56,56,0
2023,1,منطقة الرياض,أبحاث الإعلان والسوق,صغيرة,630,3743,1515,2228,4660,4416,244
2023,1,منطقة الرياض,أبحاث الإعلان والسوق,كبيرة,6,7742,6359,1383,1271,1017,254
2023,1,منطقة الرياض,أبحاث الإعلان والسوق,متناهية الصغر,2033,1269,502,767,3416,3263,153
2023,1,منطقة الرياض,أبحاث الإعلان والسوق,متوسطة,38,1663,914,749,1925,1673,252
2023,1,منطقة القصيم,أبحاث الإعلان والسوق,صغيرة,35,135,56,79,257,254,3
2023,1,منطقة القصيم,أبحاث الإعلان والسوق,متناهية الصغر,159,59,39,20,313,311,2
2023,1,منطقة المدينة المنورة,أبحاث الإعلان والسوق,صغيرة,30,87,45,42,157,157,0
2023,1,منطقة المدينة المنورة,أبحاث الإعلان والسوق,متناهية الصغر,227,82,33,49,410,398,12
2023,1,منطقة تبوك,أبحاث الإعلان والسوق,صغيرة,10,34,15,19,67,65,2
2023,1,منطقة تبوك,أبحاث الإعلان والسوق,متناهية الصغر,86,26,15,11,183,180,3
2023,1,منطقة جازان,أبحاث الإعلان والسوق,صغيرة,11,26,12,14,73,68,5
2023,1,منطقة جازان,أبحاث الإعلان والسوق,متناهية الصغر,102,25,12,13,202,200,2
2023,1,منطقة حائل,أبحاث الإعلان والسوق,صغيرة,4,6,1,5,22,22,0
2023,1,منطقة حائل,أبحاث الإعلان والسوق,متناهية الصغر,74,23,7,16,155,155,0
2023,1,منطقة عسير,أبحاث الإعلان والسوق,صغيرة,27,123,59,64,205,204,1
2023,1,منطقة عسير,أبحاث الإعلان والسوق,متناهية الصغر,171,70,35,35,332,331,1
2023,1,منطقة عسير,أبحاث الإعلان والسوق,متوسطة,1,82,1,81,2,2,0
2023,1,منطقة مكة المكرمة,أبحاث الإعلان والسوق,صغيرة,359,1840,766,1074,2785,2603,182
2023,1,منطقة مكة المكرمة,أبحاث الإعلان والسوق,كبيرة,1,77,74,3,227,226,1
2023,1,منطقة مكة المكرمة,أبحاث الإعلان والسوق,متناهية الصغر,1568,770,313,457,2918,2733,185
2023,1,منطقة مكة المكرمة,أبحاث الإعلان والسوق,متوسطة,19,889,422,467,811,728,83
2023,1,منطقة نجران,أبحاث الإعلان والسوق,صغيرة,9,30,10,20,85,85,0
2023,1,منطقة نجران,أبحاث الإعلان والسوق,متناهية الصغر,45,14,9,5,107,105,2
2023,1,المنطقة الشرقية,غير معرف,صغيرة,215,452,234,218,1842,1763,79
2023,1,المنطقة الشرقية,غير معرف,كبيرة,1,0,0,0,308,244,64
2023,1,المنطقة الشرقية,غير معرف,متناهية الصغر,6550,1144,587,557,11560,11469,91
2023,1,المنطقة الشرقية,غير معرف,متوسطة,2,14,9,5,202,202,0
2023,1,منطقة الباحة,غير معرف,صغيرة,13,30,22,8,87,87,0
2023,1,منطقة الباحة,غير معرف,متناهية الصغر,863,119,87,32,1333,1321,12
2023,1,منطقة الجوف,غير معرف,صغيرة,25,47,19,28,172,172,0
2023,1,منطقة الجوف,غير معرف,متناهية الصغر,1601,117,73,44,2653,2629,24
2023,1,منطقة الحدود الشمالية,غير معرف,صغيرة,19,38,16,22,123,123,0
2023,1,منطقة الحدود الشمالية,غير معرف,متناهية الصغر,662,75,42,33,1148,1142,6
2023,1,منطقة الرياض,غير معرف,صغيرة,1136,2402,889,1513,9078,8944,134
2023,1,منطقة الرياض,غير معرف,كبيرة,7,1544,957,587,2273,1917,356
2023,1,منطقة الرياض,غير معرف,متناهية الصغر,74623,6181,2899,3282,169000,167454,1546
2023,1,منطقة الرياض,غير معرف,متوسطة,27,563,253,310,1932,1872,60
2023,1,منطقة القصيم,غير معرف,صغيرة,70,116,61,55,693,690,3
2023,1,منطقة القصيم,غير معرف,متناهية الصغر,3155,350,185,165,6186,6136,50
2023,1,منطقة القصيم,غير معرف,متوسطة,2,63,36,27,99,58,41
2023,1,منطقة المدينة المنورة,غير معرف,صغيرة,101,198,112,86,799,795,4
2023,1,منطقة المدينة المنورة,غير معرف,متناهية الصغر,4784,557,323,234,8000,7847,153
2023,1,منطقة تبوك,غير معرف,صغيرة,37,59,32,27,318,318,0
2023,1,منطقة تبوك,غير معرف,متناهية الصغر,1835,217,122,95,2993,2970,23
2023,1,منطقة تبوك,غير معرف,متوسطة,1,2,2,0,82,42,40
2023,1,منطقة جازان,غير معرف,صغيرة,54,118,45,73,419,414,5
2023,1,منطقة جازان,غير معرف,متناهية الصغر,3746,365,204,161,6473,6405,68
2023,1,منطقة جازان,غير معرف,متوسطة,1,17,13,4,117,117,0
2023,1,منطقة حائل,غير معرف,صغيرة,34,76,45,31,342,339,3
2023,1,منطقة حائل,غير معرف,متناهية الصغر,3633,255,125,130,7524,7489,35
2023,1,منطقة حائل,غير معرف,متوسطة,1,0,0,0,117,61,56
2023,1,منطقة عسير,غير معرف,صغيرة,104,188,131,57,743,738,5
2023,1,منطقة عسير,غير معرف,متناهية الصغر,5657,647,398,249,8556,8498,58
2023,1,منطقة عسير,غير معرف,متوسطة,2,6,4,2,187,187,0
2023,1,منطقة مكة المكرمة,غير معرف,صغيرة,411,747,382,365,3415,3331,84
2023,1,منطقة مكة المكرمة,غير معرف,متناهية الصغر,15906,2160,1150,1010,26704,25862,842
2023,1,منطقة مكة المكرمة,غير معرف,متوسطة,8,225,129,96,585,582,3
2023,1,منطقة نجران,غير معرف,صغيرة,46,59,23,36,433,432,1
2023,1,منطقة نجران,غير معرف,متناهية الصغر,3306,239,131,108,6891,6849,42
